AAAAAAAGGCT -> AAAAAAGGCTA
AAAAAAGGCTA -> AAAAAGGCTAA
AAAAAATATGC -> AAAAATATGCG
AAAAACCAGTG -> AAAACCAGTGG
AAAAAGGCTAA -> AAAAGGCTAAA
AAAAATATGCG -> AAAATATGCGA
AAAAATTCAGT -> AAAATTCAGTT
AAAACCAGTGG -> AAACCAGTGGT
AAAAGGCTAAA -> AAAGGCTAAAC
AAAATACAATG -> AAATACAATGG
AAAATATGCCA -> AAATATGCCAC
AAAATATGCGA -> AAATATGCGAA
AAAATTCAGTT -> AAATTCAGTTA
AAACAAACGAA -> AACAAACGAAA
AAACATATCGC -> AACATATCGCT
AAACCAGTGGT -> AACCAGTGGTC
AAACCGACGTT -> AACCGACGTTT
AAACCGTGCTT -> AACCGTGCTTT
AAACCTCTAAA -> AACCTCTAAAC
AAACGAAACTA -> AACGAAACTAG
AAACGCTGACC -> AACGCTGACCC
AAACGGCGTCT -> AACGGCGTCTA
AAACGGTCATC -> AACGGTCATCG
AAACTAGGAAG -> AACTAGGAAGA
AAAGCACCGTA -> AAGCACCGTAC
AAAGCAGATTA -> AAGCAGATTAA
AAAGCGTTGGC -> AAGCGTTGGCA
AAAGCTGGTTC -> AAGCTGGTTCT
AAAGCTTTTAT -> AAGCTTTTATC
AAAGGCTAAAC -> AAGGCTAAACG
AAAGTTGCCTG -> AAGTTGCCTGT
AAATAACCGCC -> AATAACCGCCT
AAATACAATGG -> AATACAATGGC
AAATATGCCAC -> AATATGCCACT
AAATATGCGAA -> AATATGCGAAT
AAATATTATGT -> AATATTATGTA
AAATCCTAAGA -> AATCCTAAGAA
AAATCGAATAG -> AATCGAATAGA
AAATCTGATAA -> AATCTGATAAA
AAATTCAGTTA -> AATTCAGTTAT
AAATTGGAAAG -> AATTGGAAAGT
AACAAACGAAA -> ACAAACGAAAC
AACACACTGAA -> ACACACTGAAT
AACACAGCGTA -> ACACAGCGTAC
AACACCCGTAG -> ACACCCGTAGA
AACACCGAGTT -> ACACCGAGTTA
AACACCTGACG -> ACACCTGACGG
AACACGCACCC -> ACACGCACCCT
AACAGAGAGAT -> ACAGAGAGATA
AACAGCACCCC -> ACAGCACCCCG
AACATACCCAA -> ACATACCCAAT
AACATAGCAAA -> ACATAGCAAAG
AACATATCGCT -> ACATATCGCTG
AACCAGTGGTC -> ACCAGTGGTCT
AACCATTGAAC -> ACCATTGAACA
AACCCATCTAC -> ACCCATCTACG
AACCCGTCATG -> ACCCGTCATGT
AACCCTTATTG -> ACCCTTATTGG
AACCGACGTTT -> ACCGACGTTTG
AACCGCCTATC -> ACCGCCTATCG
AACCGTGCTTT -> ACCGTGCTTTA
AACCGTTAACT -> ACCGTTAACTT
AACCTCAAAGC -> ACCTCAAAGCT
AACCTCTAAAC -> ACCTCTAAACA
AACCTCTCTAA -> ACCTCTCTAAT
AACGAAACTAG -> ACGAAACTAGG
AACGCTGACCC -> ACGCTGACCCG
AACGGCGTCTA -> ACGGCGTCTAC
AACGGGCAGAA -> ACGGGCAGAAG
AACGGTCATCG -> ACGGTCATCGC
AACTAACACAC -> ACTAACACACT
AACTAACACGC -> ACTAACACGCA
AACTAGGAAGA -> ACTAGGAAGAG
AACTGCGCTGC -> ACTGCGCTGCC
AACTTCTAGCA -> ACTTCTAGCAA
AACTTGACGTG -> ACTTGACGTGA
AAGAAAAAATA -> AGAAAAAATAT
AAGAAACCTCT -> AGAAACCTCTA
AAGAATAGAAC -> AGAATAGAACA
AAGAATCCGCG -> AGAATCCGCGA
AAGACTCTGCG -> AGACTCTGCGG
AAGAGAGTAAA -> AGAGAGTAAAT
AAGAGCGGACC -> AGAGCGGACCA
AAGAGGACTGG -> AGAGGACTGGT
AAGAGGAGAGA -> AGAGGAGAGAT
AAGATATAGCC -> AGATATAGCCC
AAGCAAGAAAC -> AGCAAGAAACC
AAGCACCGTAC -> AGCACCGTACC
AAGCAGATTAA -> AGCAGATTAAA
AAGCCCCTGCT -> AGCCCCTGCTA
AAGCCTCCAGT -> AGCCTCCAGTA
AAGCGTTGGCA -> AGCGTTGGCAG
AAGCTCCATGT -> AGCTCCATGTT
AAGCTGGTTCT -> AGCTGGTTCTT
AAGCTTGGAAG -> AGCTTGGAAGA
AAGCTTTTATC -> AGCTTTTATCA
AAGGACGACCC -> AGGACGACCCT
AAGGAGTAAAA -> AGGAGTAAAAT
AAGGATACCCA -> AGGATACCCAA
AAGGCGGTTAA -> AGGCGGTTAAC
AAGGCTAAACG -> AGGCTAAACGC
AAGGGGGGTTA -> AGGGGGGTTAT
AAGGGTAGTGA -> AGGGTAGTGAG
AAGGTCCGAAC -> AGGTCCGAACA
AAGGTCTGACG -> AGGTCTGACGA
AAGGTGTCTTC -> AGGTGTCTTCA
AAGGTTCAGCT -> AGGTTCAGCTC
AAGGTTTTAGT -> AGGTTTTAGTT
AAGTAGCAGAA -> AGTAGCAGAAG
AAGTATGAGCG -> AGTATGAGCGG
AAGTGGTGGTA -> AGTGGTGGTAG
AAGTTCACTCT -> AGTTCACTCTT
AAGTTGCCTGT -> AGTTGCCTGTG
AAGTTGTTGGC -> AGTTGTTGGCG
AATAACCGCCT -> ATAACCGCCTA
AATAATAGAGA -> ATAATAGAGAT
AATACAATGGC -> ATACAATGGCT
AATAGAACACA -> ATAGAACACAG
AATAGAAGGGG -> ATAGAAGGGGG
AATAGAGATGA -> ATAGAGATGAT
AATAGTGCGCC -> ATAGTGCGCCT
AATATGCCACT -> ATATGCCACTA
AATATGCGAAT -> ATATGCGAATT
AATATGGCACT -> ATATGGCACTG
AATATTATGTA -> ATATTATGTAT
AATCACCCGAC -> ATCACCCGACC
AATCATGCGAA -> ATCATGCGAAG
AATCCCGAGAG -> ATCCCGAGAGA
AATCCGCGACC -> ATCCGCGACCG
AATCCTAAGAA -> ATCCTAAGAAA
AATCCTACAGC -> ATCCTACAGCT
AATCCTGGGAA -> ATCCTGGGAAG
AATCCTTACTA -> ATCCTTACTAG
AATCGAATAGA -> ATCGAATAGAA
AATCGCGCAAC -> ATCGCGCAACC
AATCTGATAAA -> ATCTGATAAAG
AATGGCTAACG -> ATGGCTAACGG
AATGGTGGGTC -> ATGGTGGGTCT
AATGTATAGAT -> ATGTATAGATT
AATGTGTGCCA -> ATGTGTGCCAC
AATGTTCCTAA -> ATGTTCCTAAG
AATTACACGTA -> ATTACACGTAC
AATTACTGTAA -> ATTACTGTAAC
AATTCAGTTAT -> ATTCAGTTATT
AATTCGCACGT -> ATTCGCACGTA
AATTGGAAAGT -> ATTGGAAAGTT
ACAAACGAAAC -> CAAACGAAACT
ACAATCCTACA -> CAATCCTACAG
ACAATGGCTAA -> CAATGGCTAAC
ACAATGTATAG -> CAATGTATAGA
ACACACTGAAT -> CACACTGAATG
ACACAGCGTAC -> CACAGCGTACG
ACACCCGTAGA -> CACCCGTAGAA
ACACCGAGTTA -> CACCGAGTTAT
ACACCTGACGG -> CACCTGACGGA
ACACCTGATTT -> CACCTGATTTC
ACACGACTGGG -> CACGACTGGGT
ACACGCACCCT -> CACGCACCCTT
ACACGTACGAA -> CACGTACGAAT
ACACTGAATGT -> CACTGAATGTG
ACAGAATCCTT -> CAGAATCCTTA
ACAGAGAGATA -> CAGAGAGATAT
ACAGCACCCCG -> CAGCACCCCGC
ACAGCGTACGA -> CAGCGTACGAT
ACAGCTTCGCA -> CAGCTTCGCAA
ACAGTGAAACC -> CAGTGAAACCG
ACAGTGTATTG -> CAGTGTATTGA
ACAGTTTCGGT -> CAGTTTCGGTG
ACATACCCAAT -> CATACCCAATA
ACATAGCAAAG -> CATAGCAAAGC
ACATATCGCTG -> CATATCGCTGA
ACATTACCCTC -> CATTACCCTCA
ACCAAGACTCT -> CCAAGACTCTG
ACCAAGCTCCA -> CCAAGCTCCAT
ACCAAGGACGA -> CCAAGGACGAC
ACCAAGGTTTT -> CCAAGGTTTTA
ACCACTAGGCG -> CCACTAGGCGA
ACCAGAAGCTT -> CCAGAAGCTTG
ACCAGCACTTC -> CCAGCACTTCG
ACCAGTGGTCT -> CCAGTGGTCTG
ACCATCCTCTC -> CCATCCTCTCT
ACCATTGAACA -> CCATTGAACAG
ACCCAACCCTT -> CCCAACCCTTA
ACCCAATAATA -> CCCAATAATAG
ACCCAATATGG -> CCCAATATGGC
ACCCATCTACG -> CCCATCTACGT
ACCCCGCGCAA -> CCCCGCGCAAG
ACCCCTCTGAA -> CCCCTCTGAAA
ACCCGACACGA -> CCCGACACGAC
ACCCGACCTGT -> CCCGACCTGTC
ACCCGGAACCT -> CCCGGAACCTC
ACCCGTAGAAA -> CCCGTAGAAAT
ACCCGTCATGT -> CCCGTCATGTG
ACCCTACCGCG -> CCCTACCGCGT
ACCCTCAGACC -> CCCTCAGACCC
ACCCTCTATAT -> CCCTCTATATC
ACCCTTATTGG -> CCCTTATTGGC
ACCCTTCTTAC -> CCCTTCTTACG
ACCGAACCATT -> CCGAACCATTG
ACCGACGTTTG -> CCGACGTTTGA
ACCGACTGCCC -> CCGACTGCCCG
ACCGAGTTATA -> CCGAGTTATAG
ACCGATCCTCG -> CCGATCCTCGT
ACCGCCTATCG -> CCGCCTATCGG
ACCGCGTAGAA -> CCGCGTAGAAA
ACCGCGTTCTC -> CCGCGTTCTCC
ACCGGTAATTA -> CCGGTAATTAC
ACCGGTGCGCG -> CCGGTGCGCGC
ACCGTACCGGT -> CCGTACCGGTA
ACCGTGCTTTA -> CCGTGCTTTAT
ACCGTTAACTT -> CCGTTAACTTG
ACCTAGCGGAT -> CCTAGCGGATA
ACCTCAAAGCT -> CCTCAAAGCTG
ACCTCTAAACA -> CCTCTAAACAT
ACCTCTCTAAT -> CCTCTCTAATC
ACCTGACGGAT -> CCTGACGGATA
ACCTGATTTCA -> CCTGATTTCAT
ACCTGTCGAGC -> CCTGTCGAGCG
ACCTTACAGTG -> CCTTACAGTGA
ACGAAACCGTG -> CGAAACCGTGC
ACGAAACTAGG -> CGAAACTAGGA
ACGAATCACCC -> CGAATCACCCG
ACGACCCTACC -> CGACCCTACCG
ACGACCGATCC -> CGACCGATCCT
ACGACTCTATC -> CGACTCTATCT
ACGACTGGGTC -> CGACTGGGTCG
ACGAGTACTCT -> CGAGTACTCTT
ACGATCGATGT -> CGATCGATGTT
ACGATGCTGAT -> CGATGCTGATC
ACGATGTACGA -> CGATGTACGAA
ACGATTATTAC -> CGATTATTACA
ACGCACCCTTC -> CGCACCCTTCT
ACGCCCAGCCG -> CGCCCAGCCGT
ACGCCGCGTAT -> CGCCGCGTATT
ACGCGAGAGAT -> CGCGAGAGATT
ACGCGGGTAAA -> CGCGGGTAAAC
ACGCTGACCCG -> CGCTGACCCGG
ACGGATACCAG -> CGGATACCAGC
ACGGCGATAAT -> CGGCGATAATA
ACGGCGGCGCG -> CGGCGGCGCGC
ACGGCGTCTAC -> CGGCGTCTACT
ACGGGCAGAAG -> CGGGCAGAAGG
ACGGTCATCGC -> CGGTCATCGCC
ACGTACGAATC -> CGTACGAATCA
ACGTAGGTCAG -> CGTAGGTCAGG
ACGTCAATCGC -> CGTCAATCGCG
ACGTGAGAATT -> CGTGAGAATTC
ACGTGAGCTCG -> CGTGAGCTCGG
ACGTGTTGCCA -> CGTGTTGCCAC
ACGTTAAATCT -> CGTTAAATCTG
ACGTTGAGGAG -> CGTTGAGGAGG
ACGTTTGAAAA -> CGTTTGAAAAA
ACTAAAGCGTT -> CTAAAGCGTTG
ACTAACACACT -> CTAACACACTG
ACTAACACGCA -> CTAACACGCAC
ACTACCCTCTA -> CTACCCTCTAT
ACTAGGAAGAG -> CTAGGAAGAGG
ACTAGGCGACT -> CTAGGCGACTC
ACTAGTGTGGG -> CTAGTGTGGGA
ACTATACGTTA -> CTATACGTTAA
ACTATCGAATC -> CTATCGAATCC
ACTCGGCGATC -> CTCGGCGATCT
ACTCTATCTAT -> CTCTATCTATT
ACTCTCACCTT -> CTCTCACCTTA
ACTCTGCGGTA -> CTCTGCGGTAA
ACTCTTCTAAG -> CTCTTCTAAGA
ACTCTTTCCTT -> CTCTTTCCTTC
ACTGAATGTGT -> CTGAATGTGTG
ACTGCCCGGTG -> CTGCCCGGTGG
ACTGCGCTGCC -> CTGCGCTGCCG
ACTGGAGCATG -> CTGGAGCATGC
ACTGGCGGATC -> CTGGCGGATCA
ACTGGGTCGGT -> CTGGGTCGGTT
ACTGGTTCGGG -> CTGGTTCGGGG
ACTGTAACAGC -> CTGTAACAGCA
ACTTCGGCGGT -> CTTCGGCGGTA
ACTTCGTACAT -> CTTCGTACATT
ACTTCTAGCAA -> CTTCTAGCAAG
ACTTGACGTGA -> CTTGACGTGAG
AGAAAAAATAT -> GAAAAAATATG
AGAAACCTCTA -> GAAACCTCTAA
AGAAATATTAT -> GAAATATTATG
AGAAATTGGAA -> GAAATTGGAAA
AGAACACAGCG -> GAACACAGCGT
AGAACTAACAC -> GAACTAACACA
AGAAGCCCCTG -> GAAGCCCCTGC
AGAAGCCTCCA -> GAAGCCTCCAG
AGAAGCTTGGA -> GAAGCTTGGAA
AGAAGGCGGTT -> GAAGGCGGTTA
AGAAGGGGGGT -> GAAGGGGGGTT
AGAAGGTTCAG -> GAAGGTTCAGC
AGAATAGAACA -> GAATAGAACAC
AGAATCCGCGA -> GAATCCGCGAC
AGAATCCTTAC -> GAATCCTTACT
AGAATTCGCAC -> GAATTCGCACG
AGACCCCTCTG -> GACCCCTCTGA
AGACCTAGCGG -> GACCTAGCGGA
AGACTCTGCGG -> GACTCTGCGGT
AGAGAGATATC -> GAGAGATATCT
AGAGAGTAAAT -> GAGAGTAAATA
AGAGATAAGGG -> GAGATAAGGGT
AGAGATAAGGT -> GAGATAAGGTC
AGAGATATCTA -> GAGATATCTAC
AGAGATGATGC -> GAGATGATGCA
AGAGATTTCTG -> GAGATTTCTGA
AGAGCCGTGTC -> GAGCCGTGTCA
AGAGCGGACCA -> GAGCGGACCAT
AGAGGACTGGT -> GAGGACTGGTT
AGAGGAGAGAT -> GAGGAGAGATA
AGAGGTCTATA -> GAGGTCTATAT
AGAGTAAATAA -> GAGTAAATAAC
AGATAAGGGTA -> GATAAGGGTAG
AGATAAGGTCT -> GATAAGGTCTG
AGATATAGCCC -> GATATAGCCCA
AGATATCTACG -> GATATCTACGC
AGATGATGCAG -> GATGATGCAGA
AGATTAAATCC -> GATTAAATCCT
AGATTTCTGAT -> GATTTCTGATG
AGATTTGCTTC -> GATTTGCTTCG
AGCAAAGCTTT -> GCAAAGCTTTT
AGCAAGAAACC -> GCAAGAAACCT
AGCAAGAGCGG -> GCAAGAGCGGA
AGCACCCCGCG -> GCACCCCGCGC
AGCACCGTACC -> GCACCGTACCG
AGCACTTCGGC -> GCACTTCGGCG
AGCAGAAGGTT -> GCAGAAGGTTC
AGCAGATTAAA -> GCAGATTAAAT
AGCATGCTGTG -> GCATGCTGTGA
AGCATGGTGTG -> GCATGGTGTGG
AGCCCACGATG -> GCCCACGATGC
AGCCCAGCGGC -> GCCCAGCGGCC
AGCCCCTGCTA -> GCCCCTGCTAA
AGCCGAAGAAT -> GCCGAAGAATA
AGCCGTGTCAT -> GCCGTGTCATG
AGCCGTTTGTC -> GCCGTTTGTCA
AGCCTCCAGTA -> GCCTCCAGTAT
AGCGAACACCG -> GCGAACACCGA
AGCGACGTGAG -> GCGACGTGAGC
AGCGATTCATC -> GCGATTCATCT
AGCGGAACATA -> GCGGAACATAC
AGCGGACCATC -> GCGGACCATCC
AGCGGATAGCG -> GCGGATAGCGA
AGCGGCCTCTG -> GCGGCCTCTGA
AGCGGCTCTGT -> GCGGCTCTGTT
AGCGTACGATG -> GCGTACGATGT
AGCGTTGGCAG -> GCGTTGGCAGT
AGCTAGAGCCG -> GCTAGAGCCGT
AGCTCCATGTT -> GCTCCATGTTC
AGCTCGAATGG -> GCTCGAATGGT
AGCTCGGGACA -> GCTCGGGACAG
AGCTGGTTCTT -> GCTGGTTCTTG
AGCTTCGCAAC -> GCTTCGCAACT
AGCTTGGAAGA -> GCTTGGAAGAA
AGCTTTTATCA -> GCTTTTATCAT
AGGAACATAGC -> GGAACATAGCA
AGGAACTGCGC -> GGAACTGCGCT
AGGAAGAGGAC -> GGAAGAGGACT
AGGACGACCCT -> GGACGACCCTA
AGGACTGGTTC -> GGACTGGTTCG
AGGAGACCTAG -> GGAGACCTAGC
AGGAGAGATAA -> GGAGAGATAAG
AGGAGGAACTG -> GGAGGAACTGC
AGGAGTAAAAT -> GGAGTAAAATA
AGGATACCCAA -> GGATACCCAAC
AGGCGACTCTC -> GGCGACTCTCA
AGGCGGTCCAA -> GGCGGTCCAAA
AGGCGGTTAAC -> GGCGGTTAACC
AGGCTAAACGC -> GGCTAAACGCT
AGGGAGGTGCG -> GGGAGGTGCGG
AGGGGGGTTAT -> GGGGGGTTATG
AGGGTAGTGAG -> GGGTAGTGAGG
AGGTCAGGCGG -> GGTCAGGCGGT
AGGTCCGAACA -> GGTCCGAACAC
AGGTCTATATA -> GGTCTATATAG
AGGTCTGACGA -> GGTCTGACGAC
AGGTGCGGCCC -> GGTGCGGCCCA
AGGTGTCTTCA -> GGTGTCTTCAT
AGGTTCACTAT -> GGTTCACTATC
AGGTTCAGCTC -> GGTTCAGCTCG
AGGTTTGCTGG -> GGTTTGCTGGA
AGGTTTTAGTT -> GGTTTTAGTTC
AGTAAAATATG -> GTAAAATATGC
AGTAAATAACC -> GTAAATAACCG
AGTACTCTTCT -> GTACTCTTCTA
AGTAGCAGAAG -> GTAGCAGAAGG
AGTAGGGAGGT -> GTAGGGAGGTG
AGTATATAGGT -> GTATATAGGTT
AGTATGAGCGG -> GTATGAGCGGC
AGTGAAACCGA -> GTGAAACCGAC
AGTGAGGAACA -> GTGAGGAACAT
AGTGCGCCTTC -> GTGCGCCTTCT
AGTGGTCTGTC -> GTGGTCTGTCC
AGTGGTGGTAG -> GTGGTGGTAGC
AGTGTATTGAT -> GTGTATTGATC
AGTGTGGGATA -> GTGTGGGATAA
AGTTATAGTTG -> GTTATAGTTGT
AGTTATTTGTT -> GTTATTTGTTA
AGTTCACCACT -> GTTCACCACTA
AGTTCACTCTT -> GTTCACTCTTT
AGTTGCCTGTG -> GTTGCCTGTGC
AGTTGCGCGGC -> GTTGCGCGGCC
AGTTGTCATTA -> GTTGTCATTAT
AGTTGTTGGCG -> GTTGTTGGCGA
AGTTTCGGTGT -> GTTTCGGTGTC
ATAAAAACCAG -> TAAAAACCAGT
ATAAAGCAGAT -> TAAAGCAGATT
ATAACCGCCTA -> TAACCGCCTAT
ATAAGGGTAGT -> TAAGGGTAGTG
ATAAGGTCTGA -> TAAGGTCTGAC
ATAATAGAGAT -> TAATAGAGATG
ATAATAGTGCG -> TAATAGTGCGC
ATACAATGGCT -> TACAATGGCTA
ATACCAGCACT -> TACCAGCACTT
ATACCCAACCC -> TACCCAACCCT
ATACCCAATAA -> TACCCAATAAT
ATACGTTAAAT -> TACGTTAAATC
ATAGAACACAG -> TAGAACACAGC
ATAGAACTAAC -> TAGAACTAACA
ATAGAAGGGGG -> TAGAAGGGGGG
ATAGAGATGAT -> TAGAGATGATG
ATAGATTTGCT -> TAGATTTGCTT
ATAGCAAAGCT -> TAGCAAAGCTT
ATAGCATGGTG -> TAGCATGGTGT
ATAGCCCAGCG -> TAGCCCAGCGG
ATAGCGAACAC -> TAGCGAACACC
ATAGGTTCACT -> TAGGTTCACTA
ATAGTGCGCCT -> TAGTGCGCCTT
ATAGTTGTCAT -> TAGTTGTCATT
ATATAGAACTA -> TATAGAACTAA
ATATAGCCCAG -> TATAGCCCAGC
ATATAGGTTCA -> TATAGGTTCAC
ATATCGCTGAG -> TATCGCTGAGA
ATATCTACGCC -> TATCTACGCCG
ATATCTCCTCA -> TATCTCCTCAG
ATATCTGACGC -> TATCTGACGCC
ATATGCCACTA -> TATGCCACTAA
ATATGCGAATT -> TATGCGAATTA
ATATGGCACTG -> TATGGCACTGG
ATATTATGTAT -> TATTATGTATG
ATATTTCGGTA -> TATTTCGGTAC
ATCAAGGAGTA -> TCAAGGAGTAA
ATCACCAAGGA -> TCACCAAGGAC
ATCACCCGACC -> TCACCCGACCT
ATCACGCGGGT -> TCACGCGGGTA
ATCATCACGCG -> TCATCACGCGG
ATCATGCGAAG -> TCATGCGAAGT
ATCATGTAAAC -> TCATGTAAACG
ATCCAGGAGAC -> TCCAGGAGACC
ATCCCGAGAGA -> TCCCGAGAGAT
ATCCCTATCTT -> TCCCTATCTTT
ATCCGCGACCG -> TCCGCGACCGG
ATCCTAAGAAA -> TCCTAAGAAAA
ATCCTACAGCT -> TCCTACAGCTT
ATCCTCAAAAT -> TCCTCAAAATA
ATCCTCGTAAA -> TCCTCGTAAAA
ATCCTCTCTAC -> TCCTCTCTACT
ATCCTGGGAAG -> TCCTGGGAAGG
ATCCTTACTAG -> TCCTTACTAGT
ATCGAATAGAA -> TCGAATAGAAG
ATCGAATCCCG -> TCGAATCCCGA
ATCGATGTTCC -> TCGATGTTCCA
ATCGCCACCAA -> TCGCCACCAAG
ATCGCGCAACC -> TCGCGCAACCC
ATCGCTGAGAG -> TCGCTGAGAGG
ATCGGTATCGT -> TCGGTATCGTC
ATCGTCGCTCG -> TCGTCGCTCGG
ATCTACGCCGC -> TCTACGCCGCG
ATCTACGTTGA -> TCTACGTTGAG
ATCTACTTCGT -> TCTACTTCGTA
ATCTAGCGATT -> TCTAGCGATTC
ATCTATCCTCA -> TCTATCCTCAA
ATCTATTCACC -> TCTATTCACCC
ATCTCCTCAGC -> TCTCCTCAGCC
ATCTCTCCAAT -> TCTCTCCAATC
ATCTGACGCCC -> TCTGACGCCCA
ATCTGATAAAG -> TCTGATAAAGC
ATCTTCTCGGT -> TCTTCTCGGTC
ATCTTTATTTC -> TCTTTATTTCC
ATGAGCGGCTC -> TGAGCGGCTCT
ATGAGTAGGGA -> TGAGTAGGGAG
ATGATGCAGAA -> TGATGCAGAAG
ATGCACGGCGA -> TGCACGGCGAT
ATGCACGTGTT -> TGCACGTGTTG
ATGCAGAAGCC -> TGCAGAAGCCT
ATGCCACTAAA -> TGCCACTAAAG
ATGCGAAGTGG -> TGCGAAGTGGT
ATGCGAATTAC -> TGCGAATTACA
ATGCTGATCAT -> TGCTGATCATC
ATGCTGTGAAG -> TGCTGTGAAGA
ATGGAACCGTT -> TGGAACCGTTA
ATGGAAGCAAG -> TGGAAGCAAGA
ATGGCACTGGC -> TGGCACTGGCG
ATGGCTAACGG -> TGGCTAACGGG
ATGGGGTTCGA -> TGGGGTTCGAG
ATGGTGGGTCT -> TGGTGGGTCTC
ATGGTGTGGGC -> TGGTGTGGGCC
ATGTAAACGGT -> TGTAAACGGTC
ATGTACGAAAC -> TGTACGAAACC
ATGTATAGATT -> TGTATAGATTT
ATGTATGCACG -> TGTATGCACGG
ATGTGCGACCG -> TGTGCGACCGC
ATGTGTGCCAC -> TGTGTGCCACA
ATGTTCCATAG -> TGTTCCATAGC
ATGTTCCCCTT -> TGTTCCCCTTA
ATGTTCCTAAG -> TGTTCCTAAGA
ATTAAATCCTA -> TTAAATCCTAA
ATTACACGTAC -> TTACACGTACG
ATTACAGAATC -> TTACAGAATCC
ATTACCCTCAG -> TTACCCTCAGA
ATTACTCGGCG -> TTACTCGGCGA
ATTACTGTAAC -> TTACTGTAACA
ATTATCTCTCC -> TTATCTCTCCA
ATTATGTATGC -> TTATGTATGCA
ATTATTACAGA -> TTATTACAGAA
ATTATTACTCG -> TTATTACTCGG
ATTCACCCGAC -> TTCACCCGACA
ATTCAGTTATT -> TTCAGTTATTT
ATTCATCTACT -> TTCATCTACTT
ATTCGCACGTA -> TTCGCACGTAG
ATTGAACAGAG -> TTGAACAGAGA
ATTGATCTATC -> TTGATCTATCC
ATTGGAAAGTT -> TTGGAAAGTTG
ATTGGCTGTGA -> TTGGCTGTGAC
ATTTCACCAGA -> TTTCACCAGAA
ATTTCATGGAA -> TTTCATGGAAG
ATTTCCTAGCC -> TTTCCTAGCCC
ATTTCCTCGTT -> TTTCCTCGTTG
ATTTCGGTACA -> TTTCGGTACAC
ATTTCTGATGG -> TTTCTGATGGG
ATTTGTTATCT -> TTTGTTATCTA
CAAAATACAAT -> AAAATACAATG
CAAACGAAACT -> AAACGAAACTA
CAAACGGCGTC -> AAACGGCGTCT
CAAAGCTGGTT -> AAAGCTGGTTC
CAAAGCTTTTA -> AAAGCTTTTAT
CAAATCGAATA -> AAATCGAATAG
CAACACCTGAC -> AACACCTGACG
CAACCCGTCAT -> AACCCGTCATG
CAACCCTTATT -> AACCCTTATTG
CAACTAACACG -> AACTAACACGC
CAAGAAACCTC -> AAGAAACCTCT
CAAGACTCTGC -> AAGACTCTGCG
CAAGAGCGGAC -> AAGAGCGGACC
CAAGCTCCATG -> AAGCTCCATGT
CAAGGACGACC -> AAGGACGACCC
CAAGGAGTAAA -> AAGGAGTAAAA
CAAGGTCCGAA -> AAGGTCCGAAC
CAAGGTTTTAG -> AAGGTTTTAGT
CAAGTAGCAGA -> AAGTAGCAGAA
CAATAATAGAG -> AATAATAGAGA
CAATATGGCAC -> AATATGGCACT
CAATCCTACAG -> AATCCTACAGC
CAATCCTGGGA -> AATCCTGGGAA
CAATCGCGCAA -> AATCGCGCAAC
CAATGGCTAAC -> AATGGCTAACG
CAATGTATAGA -> AATGTATAGAT
CAATGTTCCTA -> AATGTTCCTAA
CACAATCCTAC -> ACAATCCTACA
CACACTGAATG -> ACACTGAATGT
CACAGCGTACG -> ACAGCGTACGA
CACCAAGCTCC -> ACCAAGCTCCA
CACCAAGGACG -> ACCAAGGACGA
CACCAAGGTTT -> ACCAAGGTTTT
CACCACTAGGC -> ACCACTAGGCG
CACCAGAAGCT -> ACCAGAAGCTT
CACCCAATATG -> ACCCAATATGG
CACCCCGCGCA -> ACCCCGCGCAA
CACCCGACACG -> ACCCGACACGA
CACCCGACCTG -> ACCCGACCTGT
CACCCGTAGAA -> ACCCGTAGAAA
CACCCTTCTTA -> ACCCTTCTTAC
CACCGAACCAT -> ACCGAACCATT
CACCGACTGCC -> ACCGACTGCCC
CACCGAGTTAT -> ACCGAGTTATA
CACCGTACCGG -> ACCGTACCGGT
CACCTGACGGA -> ACCTGACGGAT
CACCTGATTTC -> ACCTGATTTCA
CACCTTACAGT -> ACCTTACAGTG
CACGACCGATC -> ACGACCGATCC
CACGACTGGGT -> ACGACTGGGTC
CACGATCGATG -> ACGATCGATGT
CACGATGCTGA -> ACGATGCTGAT
CACGCACCCTT -> ACGCACCCTTC
CACGCGAGAGA -> ACGCGAGAGAT
CACGCGGGTAA -> ACGCGGGTAAA
CACGGCGATAA -> ACGGCGATAAT
CACGTACGAAT -> ACGTACGAATC
CACGTAGGTCA -> ACGTAGGTCAG
CACGTGTTGCC -> ACGTGTTGCCA
CACTAAAGCGT -> ACTAAAGCGTT
CACTAGGCGAC -> ACTAGGCGACT
CACTATCGAAT -> ACTATCGAATC
CACTCTTTCCT -> ACTCTTTCCTT
CACTGAATGTG -> ACTGAATGTGT
CACTGGCGGAT -> ACTGGCGGATC
CACTTCGGCGG -> ACTTCGGCGGT
CAGAAGCCCCT -> AGAAGCCCCTG
CAGAAGCCTCC -> AGAAGCCTCCA
CAGAAGCTTGG -> AGAAGCTTGGA
CAGAAGGCGGT -> AGAAGGCGGTT
CAGAAGGTTCA -> AGAAGGTTCAG
CAGAATCCTTA -> AGAATCCTTAC
CAGACCCCTCT -> AGACCCCTCTG
CAGAGAGATAT -> AGAGAGATATC
CAGATTAAATC -> AGATTAAATCC
CAGCACCCCGC -> AGCACCCCGCG
CAGCACTTCGG -> AGCACTTCGGC
CAGCCGAAGAA -> AGCCGAAGAAT
CAGCCGTTTGT -> AGCCGTTTGTC
CAGCGGCCTCT -> AGCGGCCTCTG
CAGCGTACGAT -> AGCGTACGATG
CAGCTCGAATG -> AGCTCGAATGG
CAGCTTCGCAA -> AGCTTCGCAAC
CAGGAGACCTA -> AGGAGACCTAG
CAGGCGGTCCA -> AGGCGGTCCAA
CAGGTTTGCTG -> AGGTTTGCTGG
CAGTATATAGG -> AGTATATAGGT
CAGTGAAACCG -> AGTGAAACCGA
CAGTGGTCTGT -> AGTGGTCTGTC
CAGTGTATTGA -> AGTGTATTGAT
CAGTTATTTGT -> AGTTATTTGTT
CAGTTGCGCGG -> AGTTGCGCGGC
CAGTTTCGGTG -> AGTTTCGGTGT
CATACCCAATA -> ATACCCAATAA
CATAGCAAAGC -> ATAGCAAAGCT
CATAGCATGGT -> ATAGCATGGTG
CATATCGCTGA -> ATATCGCTGAG
CATATCTGACG -> ATATCTGACGC
CATCACGCGGG -> ATCACGCGGGT
CATCCTCTCTA -> ATCCTCTCTAC
CATCGCCACCA -> ATCGCCACCAA
CATCTACGTTG -> ATCTACGTTGA
CATCTACTTCG -> ATCTACTTCGT
CATGAGTAGGG -> ATGAGTAGGGA
CATGCGAAGTG -> ATGCGAAGTGG
CATGCTGTGAA -> ATGCTGTGAAG
CATGGAAGCAA -> ATGGAAGCAAG
CATGGTGTGGG -> ATGGTGTGGGC
CATGTAAACGG -> ATGTAAACGGT
CATGTGCGACC -> ATGTGCGACCG
CATGTTCCCCT -> ATGTTCCCCTT
CATTACCCTCA -> ATTACCCTCAG
CATTATCTCTC -> ATTATCTCTCC
CATTATTACTC -> ATTATTACTCG
CATTGAACAGA -> ATTGAACAGAG
CCAAACGGCGT -> CAAACGGCGTC
CCAAATCGAAT -> CAAATCGAATA
CCAACCCTTAT -> CAACCCTTATT
CCAAGACTCTG -> CAAGACTCTGC
CCAAGCTCCAT -> CAAGCTCCATG
CCAAGGACGAC -> CAAGGACGACC
CCAAGGTCCGA -> CAAGGTCCGAA
CCAAGGTTTTA -> CAAGGTTTTAG
CCAATAATAGA -> CAATAATAGAG
CCAATATGGCA -> CAATATGGCAC
CCAATCCTGGG -> CAATCCTGGGA
CCAATGTTCCT -> CAATGTTCCTA
CCACAATCCTA -> CACAATCCTAC
CCACCAAGCTC -> CACCAAGCTCC
CCACCGACTGC -> CACCGACTGCC
CCACGATGCTG -> CACGATGCTGA
CCACTAAAGCG -> CACTAAAGCGT
CCACTAGGCGA -> CACTAGGCGAC
CCAGAAGCTTG -> CAGAAGCTTGG
CCAGCACTTCG -> CAGCACTTCGG
CCAGCCGTTTG -> CAGCCGTTTGT
CCAGCGGCCTC -> CAGCGGCCTCT
CCAGGAGACCT -> CAGGAGACCTA
CCAGTATATAG -> CAGTATATAGG
CCAGTGGTCTG -> CAGTGGTCTGT
CCATAGCATGG -> CATAGCATGGT
CCATCCTCTCT -> CATCCTCTCTA
CCATCTACGTT -> CATCTACGTTG
CCATGTTCCCC -> CATGTTCCCCT
CCATTGAACAG -> CATTGAACAGA
CCCAAACGGCG -> CCAAACGGCGT
CCCAACCCTTA -> CCAACCCTTAT
CCCAAGGTCCG -> CCAAGGTCCGA
CCCAATAATAG -> CCAATAATAGA
CCCAATATGGC -> CCAATATGGCA
CCCAATGTTCC -> CCAATGTTCCT
CCCACGATGCT -> CCACGATGCTG
CCCAGCCGTTT -> CCAGCCGTTTG
CCCAGCGGCCT -> CCAGCGGCCTC
CCCATCTACGT -> CCATCTACGTT
CCCCAATGTTC -> CCCAATGTTCC
CCCCGCGCAAG -> CCCGCGCAAGT
CCCCTCTGAAA -> CCCTCTGAAAG
CCCCTGCTAAC -> CCCTGCTAACC
CCCCTTACCAA -> CCCTTACCAAG
CCCGACACGAC -> CCGACACGACT
CCCGACCTGTC -> CCGACCTGTCG
CCCGAGAGATA -> CCGAGAGATAA
CCCGCGCAAGT -> CCGCGCAAGTA
CCCGGAACCTC -> CCGGAACCTCA
CCCGGTGGTCA -> CCGGTGGTCAA
CCCGTAGAAAT -> CCGTAGAAATT
CCCGTCATGTG -> CCGTCATGTGC
CCCTACCGCGT -> CCTACCGCGTA
CCCTATCTTTA -> CCTATCTTTAT
CCCTCAGACCC -> CCTCAGACCCC
CCCTCTATATC -> CCTCTATATCT
CCCTCTGAAAG -> CCTCTGAAAGC
CCCTGCTAACC -> CCTGCTAACCC
CCCTTACCAAG -> CCTTACCAAGA
CCCTTATTGGC -> CCTTATTGGCT
CCCTTCTTACG -> CCTTCTTACGA
CCGAACACCCG -> CGAACACCCGT
CCGAACCATTG -> CGAACCATTGA
CCGAAGAATAG -> CGAAGAATAGA
CCGACACGACT -> CGACACGACTG
CCGACCTGTCG -> CGACCTGTCGA
CCGACGTTTGA -> CGACGTTTGAA
CCGACTGCCCG -> CGACTGCCCGG
CCGAGAGATAA -> CGAGAGATAAG
CCGAGTTATAG -> CGAGTTATAGT
CCGATCCTCGT -> CGATCCTCGTA
CCGATGGAACC -> CGATGGAACCG
CCGCACGATCG -> CGCACGATCGA
CCGCCTATCGG -> CGCCTATCGGT
CCGCGACCGGT -> CGCGACCGGTG
CCGCGCAAGTA -> CGCGCAAGTAG
CCGCGTAGAAA -> CGCGTAGAAAT
CCGCGTATTTC -> CGCGTATTTCC
CCGCGTTCTCC -> CGCGTTCTCCG
CCGGAACCTCA -> CGGAACCTCAA
CCGGGAAGGAT -> CGGGAAGGATA
CCGGTAATTAC -> CGGTAATTACT
CCGGTGCGCGC -> CGGTGCGCGCA
CCGGTGGTCAA -> CGGTGGTCAAC
CCGTACCGGTA -> CGTACCGGTAA
CCGTAGAAATT -> CGTAGAAATTG
CCGTCATGTGC -> CGTCATGTGCG
CCGTGCTTTAT -> CGTGCTTTATT
CCGTGTCATGA -> CGTGTCATGAG
CCGTTAACTTG -> CGTTAACTTGA
CCGTTTGTCAC -> CGTTTGTCACC
CCTAAGAAAAA -> CTAAGAAAAAA
CCTAAGATATA -> CTAAGATATAG
CCTACAGCTTC -> CTACAGCTTCG
CCTACCGCGTA -> CTACCGCGTAG
CCTAGCCCACG -> CTAGCCCACGA
CCTAGCGGATA -> CTAGCGGATAG
CCTATCGGTAT -> CTATCGGTATC
CCTATCTTTAT -> CTATCTTTATT
CCTCAAAATAC -> CTCAAAATACA
CCTCAAAGCTG -> CTCAAAGCTGG
CCTCACGCGAG -> CTCACGCGAGA
CCTCAGACCCC -> CTCAGACCCCT
CCTCAGCCGAA -> CTCAGCCGAAG
CCTCCAGTATA -> CTCCAGTATAT
CCTCGTAAAAA -> CTCGTAAAAAA
CCTCGTTGATC -> CTCGTTGATCC
CCTCTAAACAT -> CTCTAAACATA
CCTCTATATCT -> CTCTATATCTC
CCTCTCTAATC -> CTCTCTAATCA
CCTCTCTACTG -> CTCTCTACTGG
CCTCTGAAAGC -> CTCTGAAAGCA
CCTCTGACAAT -> CTCTGACAATG
CCTGACGGATA -> CTGACGGATAC
CCTGACTATAC -> CTGACTATACG
CCTGATTTCAT -> CTGATTTCATG
CCTGCTAACCC -> CTGCTAACCCA
CCTGGGAAGGT -> CTGGGAAGGTG
CCTGTCGAGCG -> CTGTCGAGCGG
CCTGTGCGTCG -> CTGTGCGTCGC
CCTTACAGTGA -> CTTACAGTGAA
CCTTACCAAGA -> CTTACCAAGAC
CCTTACTAGTG -> CTTACTAGTGT
CCTTATTGGCT -> CTTATTGGCTG
CCTTCGTTATC -> CTTCGTTATCC
CCTTCTGCGTC -> CTTCTGCGTCC
CCTTCTTACGA -> CTTCTTACGAG
CGAAACCGTGC -> GAAACCGTGCT
CGAAACTAGGA -> GAAACTAGGAA
CGAACACCCGT -> GAACACCCGTA
CGAACACCGAG -> GAACACCGAGT
CGAACCATTGA -> GAACCATTGAA
CGAAGAATAGA -> GAAGAATAGAA
CGAAGTATGAG -> GAAGTATGAGC
CGAAGTGGTGG -> GAAGTGGTGGT
CGAATAGAAGG -> GAATAGAAGGG
CGAATCACCCG -> GAATCACCCGA
CGAATCCCGAG -> GAATCCCGAGA
CGAATGGTGGG -> GAATGGTGGGT
CGAATTACACG -> GAATTACACGT
CGACACGACTG -> GACACGACTGG
CGACCCTACCG -> GACCCTACCGC
CGACCGATCCT -> GACCGATCCTC
CGACCGCGTTC -> GACCGCGTTCT
CGACCGGTGCG -> GACCGGTGCGC
CGACCTGTCGA -> GACCTGTCGAG
CGACGTGAGCT -> GACGTGAGCTC
CGACGTTTGAA -> GACGTTTGAAA
CGACTCTATCT -> GACTCTATCTA
CGACTCTCACC -> GACTCTCACCT
CGACTGCCCGG -> GACTGCCCGGT
CGACTGGGTCG -> GACTGGGTCGG
CGAGAGATAAG -> GAGAGATAAGG
CGAGAGATTTC -> GAGAGATTTCT
CGAGCGACGTG -> GAGCGACGTGA
CGAGCGGAACA -> GAGCGGAACAT
CGAGTACTCTT -> GAGTACTCTTC
CGAGTTATAGT -> GAGTTATAGTT
CGATAATAGTG -> GATAATAGTGC
CGATCAAGGAG -> GATCAAGGAGT
CGATCCTCGTA -> GATCCTCGTAA
CGATCGATGTT -> GATCGATGTTC
CGATCTTCTCG -> GATCTTCTCGG
CGATGCTGATC -> GATGCTGATCA
CGATGGAACCG -> GATGGAACCGT
CGATGTACGAA -> GATGTACGAAA
CGATGTTCCAT -> GATGTTCCATA
CGATTATTACA -> GATTATTACAG
CGATTCATCTA -> GATTCATCTAC
CGCAACCCGTC -> GCAACCCGTCA
CGCAACTAACA -> GCAACTAACAC
CGCAAGTAGCA -> GCAAGTAGCAG
CGCACCCTTCT -> GCACCCTTCTT
CGCACCGAACC -> GCACCGAACCA
CGCACGATCGA -> GCACGATCGAT
CGCACGTAGGT -> GCACGTAGGTC
CGCAGAAGCCC -> GCAGAAGCCCC
CGCCACCAAGC -> GCCACCAAGCT
CGCCCAGCCGT -> GCCCAGCCGTT
CGCCGCGTATT -> GCCGCGTATTT
CGCCTATCGGT -> GCCTATCGGTA
CGCCTTCTGCG -> GCCTTCTGCGT
CGCGACCGGTG -> GCGACCGGTGC
CGCGAGAGATT -> GCGAGAGATTT
CGCGCAACCCG -> GCGCAACCCGT
CGCGCAAGTAG -> GCGCAAGTAGC
CGCGCACCGAA -> GCGCACCGAAC
CGCGCGCTTAC -> GCGCGCTTACG
CGCGCTTACGA -> GCGCTTACGAT
CGCGGCCGGGA -> GCGGCCGGGAA
CGCGGGTAAAC -> GCGGGTAAACA
CGCGTAGAAAT -> GCGTAGAAATA
CGCGTATTTCC -> GCGTATTTCCT
CGCGTTCTCCG -> GCGTTCTCCGA
CGCTCGGTCAG -> GCTCGGTCAGG
CGCTGACCCGG -> GCTGACCCGGA
CGCTGAGAGGT -> GCTGAGAGGTC
CGCTGCCGCAC -> GCTGCCGCACG
CGCTTACGATT -> GCTTACGATTA
CGGAACATACC -> GGAACATACCC
CGGAACCTCAA -> GGAACCTCAAA
CGGACCATCCT -> GGACCATCCTC
CGGATACCAGC -> GGATACCAGCA
CGGATAGCGAA -> GGATAGCGAAC
CGGATCACCAA -> GGATCACCAAG
CGGCCCAAACG -> GGCCCAAACGG
CGGCCGGGAAG -> GGCCGGGAAGG
CGGCCTCTGAC -> GGCCTCTGACA
CGGCGATAATA -> GGCGATAATAG
CGGCGATCTTC -> GGCGATCTTCT
CGGCGCGCGCT -> GGCGCGCGCTT
CGGCGGCGCGC -> GGCGGCGCGCG
CGGCGGTATAT -> GGCGGTATATT
CGGCGTCTACT -> GGCGTCTACTA
CGGCTCTGTTC -> GGCTCTGTTCC
CGGGAAGGATA -> GGGAAGGATAC
CGGGACAGTTT -> GGGACAGTTTC
CGGGCAGAAGG -> GGGCAGAAGGC
CGGGGACGTCA -> GGGGACGTCAA
CGGGTAAACAA -> GGGTAAACAAA
CGGTAACTTCT -> GGTAACTTCTA
CGGTAATTACT -> GGTAATTACTG
CGGTACACCTG -> GGTACACCTGA
CGGTATATTTC -> GGTATATTTCG
CGGTATCGTCG -> GGTATCGTCGC
CGGTCAGGTTT -> GGTCAGGTTTG
CGGTCATCGCC -> GGTCATCGCCA
CGGTCCAAATC -> GGTCCAAATCG
CGGTCTGTAAG -> GGTCTGTAAGT
CGGTGCGCGCA -> GGTGCGCGCAC
CGGTGGTCAAC -> GGTGGTCAACA
CGGTGTCATTA -> GGTGTCATTAT
CGGTTAACCTC -> GGTTAACCTCT
CGGTTTAAGTT -> GGTTTAAGTTG
CGTAAAAAAAG -> GTAAAAAAAGG
CGTACATTACC -> GTACATTACCC
CGTACCGGTAA -> GTACCGGTAAT
CGTACGAATCA -> GTACGAATCAC
CGTACGATGTA -> GTACGATGTAC
CGTAGAAATAT -> GTAGAAATATT
CGTAGAAATTG -> GTAGAAATTGG
CGTAGGTCAGG -> GTAGGTCAGGC
CGTATTTCCTC -> GTATTTCCTCG
CGTCAATCGCG -> GTCAATCGCGC
CGTCATGTGCG -> GTCATGTGCGA
CGTCCCAAGGT -> GTCCCAAGGTC
CGTCGCAGAAG -> GTCGCAGAAGC
CGTCGCTCGGT -> GTCGCTCGGTC
CGTCTACTACC -> GTCTACTACCC
CGTGAGAATTC -> GTGAGAATTCG
CGTGAGCTCGG -> GTGAGCTCGGG
CGTGCTTTATT -> GTGCTTTATTT
CGTGTCATGAG -> GTGTCATGAGT
CGTGTTGCCAC -> GTGTTGCCACC
CGTTAAATCTG -> GTTAAATCTGA
CGTTAACTTGA -> GTTAACTTGAC
CGTTATCCAGG -> GTTATCCAGGA
CGTTCTCCGAT -> GTTCTCCGATG
CGTTGAGGAGG -> GTTGAGGAGGA
CGTTGATCCCT -> GTTGATCCCTA
CGTTGGCAGTT -> GTTGGCAGTTG
CGTTTGAAAAA -> GTTTGAAAAAT
CGTTTGTCACC -> GTTTGTCACCA
CTAAACATATC -> TAAACATATCG
CTAAACGCTGA -> TAAACGCTGAC
CTAAAGCGTTG -> TAAAGCGTTGG
CTAACACACTG -> TAACACACTGA
CTAACACGCAC -> TAACACGCACC
CTAACCCATCT -> TAACCCATCTA
CTAACGGGCAG -> TAACGGGCAGA
CTAAGAAAAAA -> TAAGAAAAAAT
CTAAGAGAGTA -> TAAGAGAGTAA
CTAAGATATAG -> TAAGATATAGC
CTAATCATGCG -> TAATCATGCGA
CTACAGCTTCG -> TACAGCTTCGC
CTACCCTCTAT -> TACCCTCTATA
CTACCGCGTAG -> TACCGCGTAGA
CTACGCCGCGT -> TACGCCGCGTA
CTACGTTGAGG -> TACGTTGAGGA
CTACTACCCTC -> TACTACCCTCT
CTACTGGAGCA -> TACTGGAGCAT
CTACTTCGTAC -> TACTTCGTACA
CTAGAGCCGTG -> TAGAGCCGTGT
CTAGCAAGAGC -> TAGCAAGAGCG
CTAGCCCACGA -> TAGCCCACGAT
CTAGCGATTCA -> TAGCGATTCAT
CTAGCGGATAG -> TAGCGGATAGC
CTAGGAAGAGG -> TAGGAAGAGGA
CTAGGCGACTC -> TAGGCGACTCT
CTAGTGTGGGA -> TAGTGTGGGAT
CTATACGTTAA -> TATACGTTAAA
CTATATAGAAC -> TATATAGAACT
CTATATCTCCT -> TATATCTCCTC
CTATCCTCAAA -> TATCCTCAAAA
CTATCGAATCC -> TATCGAATCCC
CTATCGGTATC -> TATCGGTATCG
CTATCTATTCA -> TATCTATTCAC
CTATCTTTATT -> TATCTTTATTT
CTATTCACCCG -> TATTCACCCGA
CTCAAAATACA -> TCAAAATACAA
CTCAAAGCTGG -> TCAAAGCTGGT
CTCACCTTACA -> TCACCTTACAG
CTCACGCGAGA -> TCACGCGAGAG
CTCAGACCCCT -> TCAGACCCCTC
CTCAGCCGAAG -> TCAGCCGAAGA
CTCCAATCCTG -> TCCAATCCTGG
CTCCAGTATAT -> TCCAGTATATA
CTCCATGTTCC -> TCCATGTTCCC
CTCCGATGGAA -> TCCGATGGAAC
CTCCTCAGCCG -> TCCTCAGCCGA
CTCGAAGTATG -> TCGAAGTATGA
CTCGAATGGTG -> TCGAATGGTGG
CTCGGCGATCT -> TCGGCGATCTT
CTCGGGACAGT -> TCGGGACAGTT
CTCGGTCAGGT -> TCGGTCAGGTT
CTCGGTCTGTA -> TCGGTCTGTAA
CTCGTAAAAAA -> TCGTAAAAAAA
CTCGTTGATCC -> TCGTTGATCCC
CTCTAAACATA -> TCTAAACATAT
CTCTAATCATG -> TCTAATCATGC
CTCTACTGGAG -> TCTACTGGAGC
CTCTATATCTC -> TCTATATCTCC
CTCTATCTATT -> TCTATCTATTC
CTCTCACCTTA -> TCTCACCTTAC
CTCTCCAATCC -> TCTCCAATCCT
CTCTCTAATCA -> TCTCTAATCAT
CTCTCTACTGG -> TCTCTACTGGA
CTCTGAAAGCA -> TCTGAAAGCAC
CTCTGACAATG -> TCTGACAATGT
CTCTGCGGTAA -> TCTGCGGTAAC
CTCTGTTCCTG -> TCTGTTCCTGA
CTCTTCTAAGA -> TCTTCTAAGAG
CTCTTTCCTTC -> TCTTTCCTTCG
CTGAAAGCACC -> TGAAAGCACCG
CTGAATGTGTG -> TGAATGTGTGC
CTGACAATGTA -> TGACAATGTAT
CTGACCCGGAA -> TGACCCGGAAC
CTGACGACTCT -> TGACGACTCTA
CTGACGCCCAG -> TGACGCCCAGC
CTGACGGATAC -> TGACGGATACC
CTGACTATACG -> TGACTATACGT
CTGAGAGGTCT -> TGAGAGGTCTA
CTGATAAAGCA -> TGATAAAGCAG
CTGATCATCAC -> TGATCATCACG
CTGATGGGGTT -> TGATGGGGTTC
CTGATTTCATG -> TGATTTCATGG
CTGCCCGGTGG -> TGCCCGGTGGT
CTGCCGCACGA -> TGCCGCACGAT
CTGCGCTGCCG -> TGCGCTGCCGC
CTGCGGTAACT -> TGCGGTAACTT
CTGCGTCCCAA -> TGCGTCCCAAG
CTGCTAACCCA -> TGCTAACCCAT
CTGGACGGCGG -> TGGACGGCGGC
CTGGAGCATGC -> TGGAGCATGCT
CTGGCGGATCA -> TGGCGGATCAC
CTGGGAAGGTG -> TGGGAAGGTGT
CTGGGTCGGTT -> TGGGTCGGTTT
CTGGTTCGGGG -> TGGTTCGGGGA
CTGGTTCTTGT -> TGGTTCTTGTG
CTGTAACAGCA -> TGTAACAGCAC
CTGTAAGTTCA -> TGTAAGTTCAC
CTGTCCCCAAT -> TGTCCCCAATG
CTGTCGAGCGG -> TGTCGAGCGGA
CTGTGAAGAGG -> TGTGAAGAGGA
CTGTGACAGTG -> TGTGACAGTGT
CTGTGCGTCGC -> TGTGCGTCGCA
CTGTTCCTGAC -> TGTTCCTGACT
CTTACAGTGAA -> TTACAGTGAAA
CTTACCAAGAC -> TTACCAAGACT
CTTACGAGTAC -> TTACGAGTACT
CTTACGATTAT -> TTACGATTATT
CTTACTAGTGT -> TTACTAGTGTG
CTTATTGGCTG -> TTATTGGCTGT
CTTCATATCTG -> TTCATATCTGA
CTTCGCAACTA -> TTCGCAACTAA
CTTCGGCGGTA -> TTCGGCGGTAT
CTTCGTACATT -> TTCGTACATTA
CTTCGTTATCC -> TTCGTTATCCA
CTTCTAAGAGA -> TTCTAAGAGAG
CTTCTAGCAAG -> TTCTAGCAAGA
CTTCTCGGTCT -> TTCTCGGTCTG
CTTCTGCGTCC -> TTCTGCGTCCC
CTTCTTACGAG -> TTCTTACGAGT
CTTGACGTGAG -> TTGACGTGAGA
CTTGGAAGAAT -> TTGGAAGAATC
CTTGTGCACCC -> TTGTGCACCCA
CTTTATTTCAC -> TTTATTTCACC
CTTTATTTCCT -> TTTATTTCCTA
CTTTCCTTCGT -> TTTCCTTCGTT
CTTTTATCATG -> TTTTATCATGT
GAAAAAATATG -> AAAAAATATGC
GAAAAATTCAG -> AAAAATTCAGT
GAAACCGACGT -> AAACCGACGTT
GAAACCGTGCT -> AAACCGTGCTT
GAAACCTCTAA -> AAACCTCTAAA
GAAACTAGGAA -> AAACTAGGAAG
GAAAGCACCGT -> AAAGCACCGTA
GAAAGTTGCCT -> AAAGTTGCCTG
GAAATATTATG -> AAATATTATGT
GAAATTGGAAA -> AAATTGGAAAG
GAACACAGCGT -> AACACAGCGTA
GAACACCCGTA -> AACACCCGTAG
GAACACCGAGT -> AACACCGAGTT
GAACAGAGAGA -> AACAGAGAGAT
GAACATACCCA -> AACATACCCAA
GAACATAGCAA -> AACATAGCAAA
GAACCATTGAA -> AACCATTGAAC
GAACCGTTAAC -> AACCGTTAACT
GAACCTCAAAG -> AACCTCAAAGC
GAACTAACACA -> AACTAACACAC
GAACTGCGCTG -> AACTGCGCTGC
GAAGAATAGAA -> AAGAATAGAAC
GAAGAATCCGC -> AAGAATCCGCG
GAAGAGGACTG -> AAGAGGACTGG
GAAGAGGAGAG -> AAGAGGAGAGA
GAAGCAAGAAA -> AAGCAAGAAAC
GAAGCCCCTGC -> AAGCCCCTGCT
GAAGCCTCCAG -> AAGCCTCCAGT
GAAGCTTGGAA -> AAGCTTGGAAG
GAAGGATACCC -> AAGGATACCCA
GAAGGCGGTTA -> AAGGCGGTTAA
GAAGGGGGGTT -> AAGGGGGGTTA
GAAGGTGTCTT -> AAGGTGTCTTC
GAAGGTTCAGC -> AAGGTTCAGCT
GAAGTATGAGC -> AAGTATGAGCG
GAAGTGGTGGT -> AAGTGGTGGTA
GAATAGAACAC -> AATAGAACACA
GAATAGAAGGG -> AATAGAAGGGG
GAATCACCCGA -> AATCACCCGAC
GAATCCCGAGA -> AATCCCGAGAG
GAATCCGCGAC -> AATCCGCGACC
GAATCCTTACT -> AATCCTTACTA
GAATGGTGGGT -> AATGGTGGGTC
GAATGTGTGCC -> AATGTGTGCCA
GAATTACACGT -> AATTACACGTA
GAATTCGCACG -> AATTCGCACGT
GACAATGTATA -> ACAATGTATAG
GACACGACTGG -> ACACGACTGGG
GACAGTGTATT -> ACAGTGTATTG
GACAGTTTCGG -> ACAGTTTCGGT
GACCATCCTCT -> ACCATCCTCTC
GACCCCTCTGA -> ACCCCTCTGAA
GACCCGGAACC -> ACCCGGAACCT
GACCCTACCGC -> ACCCTACCGCG
GACCGATCCTC -> ACCGATCCTCG
GACCGCGTTCT -> ACCGCGTTCTC
GACCGGTGCGC -> ACCGGTGCGCG
GACCTAGCGGA -> ACCTAGCGGAT
GACCTGTCGAG -> ACCTGTCGAGC
GACGACCCTAC -> ACGACCCTACC
GACGACTCTAT -> ACGACTCTATC
GACGCCCAGCC -> ACGCCCAGCCG
GACGGATACCA -> ACGGATACCAG
GACGGCGGCGC -> ACGGCGGCGCG
GACGTCAATCG -> ACGTCAATCGC
GACGTGAGAAT -> ACGTGAGAATT
GACGTGAGCTC -> ACGTGAGCTCG
GACGTTTGAAA -> ACGTTTGAAAA
GACTATACGTT -> ACTATACGTTA
GACTCTATCTA -> ACTCTATCTAT
GACTCTCACCT -> ACTCTCACCTT
GACTCTGCGGT -> ACTCTGCGGTA
GACTGCCCGGT -> ACTGCCCGGTG
GACTGGGTCGG -> ACTGGGTCGGT
GACTGGTTCGG -> ACTGGTTCGGG
GAGAATTCGCA -> AGAATTCGCAC
GAGACCTAGCG -> AGACCTAGCGG
GAGAGATAAGG -> AGAGATAAGGG,AGAGATAAGGT
GAGAGATATCT -> AGAGATATCTA
GAGAGATTTCT -> AGAGATTTCTG
GAGAGGTCTAT -> AGAGGTCTATA
GAGAGTAAATA -> AGAGTAAATAA
GAGATAAGGGT -> AGATAAGGGTA
GAGATAAGGTC -> AGATAAGGTCT
GAGATATCTAC -> AGATATCTACG
GAGATGATGCA -> AGATGATGCAG
GAGATTTCTGA -> AGATTTCTGAT
GAGCATGCTGT -> AGCATGCTGTG
GAGCCGTGTCA -> AGCCGTGTCAT
GAGCGACGTGA -> AGCGACGTGAG
GAGCGGAACAT -> AGCGGAACATA
GAGCGGACCAT -> AGCGGACCATC
GAGCGGCTCTG -> AGCGGCTCTGT
GAGCTCGGGAC -> AGCTCGGGACA
GAGGAACATAG -> AGGAACATAGC
GAGGAACTGCG -> AGGAACTGCGC
GAGGACTGGTT -> AGGACTGGTTC
GAGGAGAGATA -> AGGAGAGATAA
GAGGAGGAACT -> AGGAGGAACTG
GAGGTCTATAT -> AGGTCTATATA
GAGGTGCGGCC -> AGGTGCGGCCC
GAGTAAAATAT -> AGTAAAATATG
GAGTAAATAAC -> AGTAAATAACC
GAGTACTCTTC -> AGTACTCTTCT
GAGTAGGGAGG -> AGTAGGGAGGT
GAGTTATAGTT -> AGTTATAGTTG
GATAAAAACCA -> ATAAAAACCAG
GATAAAGCAGA -> ATAAAGCAGAT
GATAAGGGTAG -> ATAAGGGTAGT
GATAAGGTCTG -> ATAAGGTCTGA
GATAATAGTGC -> ATAATAGTGCG
GATACCAGCAC -> ATACCAGCACT
GATACCCAACC -> ATACCCAACCC
GATAGCGAACA -> ATAGCGAACAC
GATATAGCCCA -> ATATAGCCCAG
GATATCTACGC -> ATATCTACGCC
GATCAAGGAGT -> ATCAAGGAGTA
GATCACCAAGG -> ATCACCAAGGA
GATCATCACGC -> ATCATCACGCG
GATCCCTATCT -> ATCCCTATCTT
GATCCTCGTAA -> ATCCTCGTAAA
GATCGATGTTC -> ATCGATGTTCC
GATCTATCCTC -> ATCTATCCTCA
GATCTTCTCGG -> ATCTTCTCGGT
GATGATGCAGA -> ATGATGCAGAA
GATGCAGAAGC -> ATGCAGAAGCC
GATGCTGATCA -> ATGCTGATCAT
GATGGAACCGT -> ATGGAACCGTT
GATGGGGTTCG -> ATGGGGTTCGA
GATGTACGAAA -> ATGTACGAAAC
GATGTTCCATA -> ATGTTCCATAG
GATTAAATCCT -> ATTAAATCCTA
GATTATTACAG -> ATTATTACAGA
GATTCATCTAC -> ATTCATCTACT
GATTTCATGGA -> ATTTCATGGAA
GATTTCTGATG -> ATTTCTGATGG
GATTTGCTTCG -> ATTTGCTTCGT
GCAAAGCTTTT -> CAAAGCTTTTA
GCAACCCGTCA -> CAACCCGTCAT
GCAACTAACAC -> CAACTAACACG
GCAAGAAACCT -> CAAGAAACCTC
GCAAGAGCGGA -> CAAGAGCGGAC
GCAAGTAGCAG -> CAAGTAGCAGA
GCACCCAATAT -> CACCCAATATG
GCACCCCGCGC -> CACCCCGCGCA
GCACCCTTCTT -> CACCCTTCTTA
GCACCGAACCA -> CACCGAACCAT
GCACCGTACCG -> CACCGTACCGG
GCACGATCGAT -> CACGATCGATG
GCACGGCGATA -> CACGGCGATAA
GCACGTAGGTC -> CACGTAGGTCA
GCACGTGTTGC -> CACGTGTTGCC
GCACTGGCGGA -> CACTGGCGGAT
GCACTTCGGCG -> CACTTCGGCGG
GCAGAAGCCCC -> CAGAAGCCCCT
GCAGAAGCCTC -> CAGAAGCCTCC
GCAGAAGGCGG -> CAGAAGGCGGT
GCAGAAGGTTC -> CAGAAGGTTCA
GCAGATTAAAT -> CAGATTAAATC
GCAGTTGCGCG -> CAGTTGCGCGG
GCATGCTGTGA -> CATGCTGTGAA
GCATGGTGTGG -> CATGGTGTGGG
GCCACAATCCT -> CCACAATCCTA
GCCACCAAGCT -> CCACCAAGCTC
GCCACCGACTG -> CCACCGACTGC
GCCACTAAAGC -> CCACTAAAGCG
GCCCAAACGGC -> CCCAAACGGCG
GCCCACGATGC -> CCCACGATGCT
GCCCAGCCGTT -> CCCAGCCGTTT
GCCCAGCGGCC -> CCCAGCGGCCT
GCCCCTGCTAA -> CCCCTGCTAAC
GCCCGGTGGTC -> CCCGGTGGTCA
GCCGAAGAATA -> CCGAAGAATAG
GCCGCACGATC -> CCGCACGATCG
GCCGCGTATTT -> CCGCGTATTTC
GCCGGGAAGGA -> CCGGGAAGGAT
GCCGTGTCATG -> CCGTGTCATGA
GCCGTTTGTCA -> CCGTTTGTCAC
GCCTATCGGTA -> CCTATCGGTAT
GCCTCACGCGA -> CCTCACGCGAG
GCCTCCAGTAT -> CCTCCAGTATA
GCCTCTGACAA -> CCTCTGACAAT
GCCTGTGCGTC -> CCTGTGCGTCG
GCCTTCTGCGT -> CCTTCTGCGTC
GCGAACACCGA -> CGAACACCGAG
GCGAAGTGGTG -> CGAAGTGGTGG
GCGAATTACAC -> CGAATTACACG
GCGACCGCGTT -> CGACCGCGTTC
GCGACCGGTGC -> CGACCGGTGCG
GCGACGTGAGC -> CGACGTGAGCT
GCGACTCTCAC -> CGACTCTCACC
GCGAGAGATTT -> CGAGAGATTTC
GCGATAATAGT -> CGATAATAGTG
GCGATCAAGGA -> CGATCAAGGAG
GCGATCTTCTC -> CGATCTTCTCG
GCGATTCATCT -> CGATTCATCTA
GCGCAACCCGT -> CGCAACCCGTC
GCGCAAGTAGC -> CGCAAGTAGCA
GCGCACCGAAC -> CGCACCGAACC
GCGCCTTCTGC -> CGCCTTCTGCG
GCGCGCACCGA -> CGCGCACCGAA
GCGCGCGCTTA -> CGCGCGCTTAC
GCGCGCTTACG -> CGCGCTTACGA
GCGCGGCCGGG -> CGCGGCCGGGA
GCGCTGCCGCA -> CGCTGCCGCAC
GCGCTTACGAT -> CGCTTACGATT
GCGGAACATAC -> CGGAACATACC
GCGGACCATCC -> CGGACCATCCT
GCGGATAGCGA -> CGGATAGCGAA
GCGGATCACCA -> CGGATCACCAA
GCGGCCCAAAC -> CGGCCCAAACG
GCGGCCGGGAA -> CGGCCGGGAAG
GCGGCCTCTGA -> CGGCCTCTGAC
GCGGCGCGCGC -> CGGCGCGCGCT
GCGGCTCTGTT -> CGGCTCTGTTC
GCGGGTAAACA -> CGGGTAAACAA
GCGGTAACTTC -> CGGTAACTTCT
GCGGTATATTT -> CGGTATATTTC
GCGGTCCAAAT -> CGGTCCAAATC
GCGGTTAACCT -> CGGTTAACCTC
GCGTACGATGT -> CGTACGATGTA
GCGTAGAAATA -> CGTAGAAATAT
GCGTATTTCCT -> CGTATTTCCTC
GCGTCCCAAGG -> CGTCCCAAGGT
GCGTCGCAGAA -> CGTCGCAGAAG
GCGTCTACTAC -> CGTCTACTACC
GCGTTCTCCGA -> CGTTCTCCGAT
GCGTTGGCAGT -> CGTTGGCAGTT
GCTAAACGCTG -> CTAAACGCTGA
GCTAACCCATC -> CTAACCCATCT
GCTAACGGGCA -> CTAACGGGCAG
GCTAGAGCCGT -> CTAGAGCCGTG
GCTCCATGTTC -> CTCCATGTTCC
GCTCGAATGGT -> CTCGAATGGTG
GCTCGGGACAG -> CTCGGGACAGT
GCTCGGTCAGG -> CTCGGTCAGGT
GCTCTGTTCCT -> CTCTGTTCCTG
GCTGACCCGGA -> CTGACCCGGAA
GCTGAGAGGTC -> CTGAGAGGTCT
GCTGATCATCA -> CTGATCATCAC
GCTGCCGCACG -> CTGCCGCACGA
GCTGGACGGCG -> CTGGACGGCGG
GCTGGTTCTTG -> CTGGTTCTTGT
GCTGTGAAGAG -> CTGTGAAGAGG
GCTGTGACAGT -> CTGTGACAGTG
GCTTACGATTA -> CTTACGATTAT
GCTTCGCAACT -> CTTCGCAACTA
GCTTGGAAGAA -> CTTGGAAGAAT
GCTTTATTTCA -> CTTTATTTCAC
GCTTTTATCAT -> CTTTTATCATG
GGAAAGTTGCC -> GAAAGTTGCCT
GGAACATACCC -> GAACATACCCA
GGAACATAGCA -> GAACATAGCAA
GGAACCGTTAA -> GAACCGTTAAC
GGAACCTCAAA -> GAACCTCAAAG
GGAACTGCGCT -> GAACTGCGCTG
GGAAGAATCCG -> GAAGAATCCGC
GGAAGAGGACT -> GAAGAGGACTG
GGAAGCAAGAA -> GAAGCAAGAAA
GGAAGGATACC -> GAAGGATACCC
GGAAGGTGTCT -> GAAGGTGTCTT
GGACAGTTTCG -> GACAGTTTCGG
GGACCATCCTC -> GACCATCCTCT
GGACGACCCTA -> GACGACCCTAC
GGACGGCGGCG -> GACGGCGGCGC
GGACGTCAATC -> GACGTCAATCG
GGACTGGTTCG -> GACTGGTTCGG
GGAGACCTAGC -> GAGACCTAGCG
GGAGAGATAAG -> GAGAGATAAGG
GGAGCATGCTG -> GAGCATGCTGT
GGAGGAACTGC -> GAGGAACTGCG
GGAGGTGCGGC -> GAGGTGCGGCC
GGAGTAAAATA -> GAGTAAAATAT
GGATAAAAACC -> GATAAAAACCA
GGATACCAGCA -> GATACCAGCAC
GGATACCCAAC -> GATACCCAACC
GGATAGCGAAC -> GATAGCGAACA
GGATCACCAAG -> GATCACCAAGG
GGCACTGGCGG -> GCACTGGCGGA
GGCAGAAGGCG -> GCAGAAGGCGG
GGCAGTTGCGC -> GCAGTTGCGCG
GGCCCAAACGG -> GCCCAAACGGC
GGCCGGGAAGG -> GCCGGGAAGGA
GGCCTCACGCG -> GCCTCACGCGA
GGCCTCTGACA -> GCCTCTGACAA
GGCGACTCTCA -> GCGACTCTCAC
GGCGATAATAG -> GCGATAATAGT
GGCGATCAAGG -> GCGATCAAGGA
GGCGATCTTCT -> GCGATCTTCTC
GGCGCGCGCTT -> GCGCGCGCTTA
GGCGGATCACC -> GCGGATCACCA
GGCGGCGCGCG -> GCGGCGCGCGC
GGCGGTATATT -> GCGGTATATTT
GGCGGTCCAAA -> GCGGTCCAAAT
GGCGGTTAACC -> GCGGTTAACCT
GGCGTCTACTA -> GCGTCTACTAC
GGCTAAACGCT -> GCTAAACGCTG
GGCTAACGGGC -> GCTAACGGGCA
GGCTCTGTTCC -> GCTCTGTTCCT
GGCTGTGACAG -> GCTGTGACAGT
GGGAAGGATAC -> GGAAGGATACC
GGGAAGGTGTC -> GGAAGGTGTCT
GGGACAGTTTC -> GGACAGTTTCG
GGGACGTCAAT -> GGACGTCAATC
GGGAGGTGCGG -> GGAGGTGCGGC
GGGATAAAAAC -> GGATAAAAACC
GGGCAGAAGGC -> GGCAGAAGGCG
GGGCCTCACGC -> GGCCTCACGCG
GGGGACGTCAA -> GGGACGTCAAT
GGGGGGTTATG -> GGGGGTTATGC
GGGGGTTATGC -> GGGGTTATGCA
GGGGTTATGCA -> GGGTTATGCAC
GGGGTTCGAGC -> GGGTTCGAGCG
GGGTAAACAAA -> GGTAAACAAAC
GGGTAGTGAGG -> GGTAGTGAGGA
GGGTCGGTTTA -> GGTCGGTTTAA
GGGTCTCGAAG -> GGTCTCGAAGT
GGGTTATGCAC -> GGTTATGCACG
GGGTTCGAGCG -> GGTTCGAGCGA
GGTAAACAAAC -> GTAAACAAACG
GGTAACTTCTA -> GTAACTTCTAG
GGTAATTACTG -> GTAATTACTGT
GGTACACCTGA -> GTACACCTGAT
GGTAGCTAGAG -> GTAGCTAGAGC
GGTAGTGAGGA -> GTAGTGAGGAA
GGTATATTTCG -> GTATATTTCGG
GGTATCGTCGC -> GTATCGTCGCT
GGTCAACACCT -> GTCAACACCTG
GGTCAGGCGGT -> GTCAGGCGGTC
GGTCAGGTTTG -> GTCAGGTTTGC
GGTCATCGCCA -> GTCATCGCCAC
GGTCCAAATCG -> GTCCAAATCGA
GGTCCGAACAC -> GTCCGAACACC
GGTCGGTTTAA -> GTCGGTTTAAG
GGTCTATATAG -> GTCTATATAGA
GGTCTCGAAGT -> GTCTCGAAGTA
GGTCTGACGAC -> GTCTGACGACT
GGTCTGTAAGT -> GTCTGTAAGTT
GGTCTGTCCCC -> GTCTGTCCCCA
GGTGCGCGCAC -> GTGCGCGCACC
GGTGCGGCCCA -> GTGCGGCCCAA
GGTGGGTCTCG -> GTGGGTCTCGA
GGTGGTAGCTA -> GTGGTAGCTAG
GGTGGTCAACA -> GTGGTCAACAC
GGTGTCATTAT -> GTGTCATTATT
GGTGTCTTCAT -> GTGTCTTCATA
GGTGTGGGCCT -> GTGTGGGCCTC
GGTTAACCTCT -> GTTAACCTCTC
GGTTATGCACG -> GTTATGCACGT
GGTTCACTATC -> GTTCACTATCG
GGTTCAGCTCG -> GTTCAGCTCGA
GGTTCGAGCGA -> GTTCGAGCGAC
GGTTCGGGGAC -> GTTCGGGGACG
GGTTCTTGTGC -> GTTCTTGTGCA
GGTTTAAGTTG -> GTTTAAGTTGT
GGTTTGCTGGA -> GTTTGCTGGAC
GGTTTTAGTTC -> GTTTTAGTTCA
GTAAAAAAAGG -> TAAAAAAAGGC
GTAAAATATGC -> TAAAATATGCC
GTAAACAAACG -> TAAACAAACGA
GTAAACGGTCA -> TAAACGGTCAT
GTAAATAACCG -> TAAATAACCGC
GTAACAGCACC -> TAACAGCACCC
GTAACTTCTAG -> TAACTTCTAGC
GTAAGTTCACT -> TAAGTTCACTC
GTAATTACTGT -> TAATTACTGTA
GTACACCTGAT -> TACACCTGATT
GTACATTACCC -> TACATTACCCT
GTACCGGTAAT -> TACCGGTAATT
GTACGAAACCG -> TACGAAACCGT
GTACGAATCAC -> TACGAATCACC
GTACGATGTAC -> TACGATGTACG
GTACTCTTCTA -> TACTCTTCTAA
GTAGAAATATT -> TAGAAATATTA
GTAGAAATTGG -> TAGAAATTGGA
GTAGCAGAAGG -> TAGCAGAAGGT
GTAGCTAGAGC -> TAGCTAGAGCC
GTAGGGAGGTG -> TAGGGAGGTGC
GTAGGTCAGGC -> TAGGTCAGGCG
GTAGTGAGGAA -> TAGTGAGGAAC
GTATAGATTTG -> TATAGATTTGC
GTATATAGGTT -> TATATAGGTTC
GTATATTTCGG -> TATATTTCGGT
GTATCGTCGCT -> TATCGTCGCTC
GTATGAGCGGC -> TATGAGCGGCT
GTATGCACGGC -> TATGCACGGCG
GTATTGATCTA -> TATTGATCTAT
GTATTTCCTCG -> TATTTCCTCGT
GTCAACACCTG -> TCAACACCTGA
GTCAATCGCGC -> TCAATCGCGCA
GTCACCAAGGT -> TCACCAAGGTT
GTCAGGCGGTC -> TCAGGCGGTCC
GTCAGGTTTGC -> TCAGGTTTGCT
GTCATCGCCAC -> TCATCGCCACC
GTCATGAGTAG -> TCATGAGTAGG
GTCATGTGCGA -> TCATGTGCGAC
GTCATTATCTC -> TCATTATCTCT
GTCATTATTAC -> TCATTATTACT
GTCCAAATCGA -> TCCAAATCGAA
GTCCCAAGGTC -> TCCCAAGGTCC
GTCCCCAATGT -> TCCCCAATGTT
GTCCGAACACC -> TCCGAACACCC
GTCGAGCGGAA -> TCGAGCGGAAC
GTCGCAGAAGC -> TCGCAGAAGCC
GTCGCTCGGTC -> TCGCTCGGTCA
GTCGGTTTAAG -> TCGGTTTAAGT
GTCTACTACCC -> TCTACTACCCT
GTCTATATAGA -> TCTATATAGAA
GTCTCGAAGTA -> TCTCGAAGTAT
GTCTGACGACT -> TCTGACGACTC
GTCTGTAAGTT -> TCTGTAAGTTC
GTCTGTCCCCA -> TCTGTCCCCAA
GTCTTCATATC -> TCTTCATATCT
GTGAAACCGAC -> TGAAACCGACG
GTGAAGAGGAG -> TGAAGAGGAGA
GTGACAGTGTA -> TGACAGTGTAT
GTGAGAATTCG -> TGAGAATTCGC
GTGAGCTCGGG -> TGAGCTCGGGA
GTGAGGAACAT -> TGAGGAACATA
GTGCACCCAAT -> TGCACCCAATA
GTGCCACAATC -> TGCCACAATCC
GTGCGACCGCG -> TGCGACCGCGT
GTGCGCCTTCT -> TGCGCCTTCTG
GTGCGCGCACC -> TGCGCGCACCG
GTGCGGCCCAA -> TGCGGCCCAAA
GTGCGTCGCAG -> TGCGTCGCAGA
GTGCTTTATTT -> TGCTTTATTTC
GTGGGATAAAA -> TGGGATAAAAA
GTGGGCCTCAC -> TGGGCCTCACG
GTGGGTCTCGA -> TGGGTCTCGAA
GTGGTAGCTAG -> TGGTAGCTAGA
GTGGTCAACAC -> TGGTCAACACC
GTGGTCTGTCC -> TGGTCTGTCCC
GTGGTGGTAGC -> TGGTGGTAGCT
GTGTATTGATC -> TGTATTGATCT
GTGTCATGAGT -> TGTCATGAGTA
GTGTCATTATT -> TGTCATTATTA
GTGTCTTCATA -> TGTCTTCATAT
GTGTGCCACAA -> TGTGCCACAAT
GTGTGGGATAA -> TGTGGGATAAA
GTGTGGGCCTC -> TGTGGGCCTCA
GTGTTGCCACC -> TGTTGCCACCG
GTTAAATCTGA -> TTAAATCTGAT
GTTAACCTCTC -> TTAACCTCTCT
GTTAACTTGAC -> TTAACTTGACG
GTTATAGTTGT -> TTATAGTTGTC
GTTATCCAGGA -> TTATCCAGGAG
GTTATCTAGCG -> TTATCTAGCGA
GTTATGCACGT -> TTATGCACGTG
GTTATTTGTTA -> TTATTTGTTAT
GTTCACCACTA -> TTCACCACTAG
GTTCACTATCG -> TTCACTATCGA
GTTCACTCTTT -> TTCACTCTTTC
GTTCAGCTCGA -> TTCAGCTCGAA
GTTCCATAGCA -> TTCCATAGCAT
GTTCCCCTTAC -> TTCCCCTTACC
GTTCCTAAGAT -> TTCCTAAGATA
GTTCCTGACTA -> TTCCTGACTAT
GTTCGAGCGAC -> TTCGAGCGACG
GTTCGGGGACG -> TTCGGGGACGT
GTTCTCCGATG -> TTCTCCGATGG
GTTCTTGTGCA -> TTCTTGTGCAC
GTTGAGGAGGA -> TTGAGGAGGAA
GTTGATCCCTA -> TTGATCCCTAT
GTTGCCACCGA -> TTGCCACCGAC
GTTGCCTGTGC -> TTGCCTGTGCG
GTTGCGCGGCC -> TTGCGCGGCCG
GTTGGCAGTTG -> TTGGCAGTTGC
GTTGGCGATCA -> TTGGCGATCAA
GTTGTCATTAT -> TTGTCATTATC
GTTGTTGGCGA -> TTGTTGGCGAT
GTTTAAGTTGT -> TTTAAGTTGTT
GTTTCGGTGTC -> TTTCGGTGTCA
GTTTGAAAAAT -> TTTGAAAAATT
GTTTGCTGGAC -> TTTGCTGGACG
GTTTGTCACCA -> TTTGTCACCAA
GTTTTAGTTCA -> TTTTAGTTCAC
TAAAAAAAGGC -> AAAAAAAGGCT
TAAAAACCAGT -> AAAAACCAGTG
TAAAATATGCC -> AAAATATGCCA
TAAACAAACGA -> AAACAAACGAA
TAAACATATCG -> AAACATATCGC
TAAACGCTGAC -> AAACGCTGACC
TAAACGGTCAT -> AAACGGTCATC
TAAAGCAGATT -> AAAGCAGATTA
TAAAGCGTTGG -> AAAGCGTTGGC
TAAATAACCGC -> AAATAACCGCC
TAAATCCTAAG -> AAATCCTAAGA
TAAATCTGATA -> AAATCTGATAA
TAACACACTGA -> AACACACTGAA
TAACACGCACC -> AACACGCACCC
TAACAGCACCC -> AACAGCACCCC
TAACCCATCTA -> AACCCATCTAC
TAACCGCCTAT -> AACCGCCTATC
TAACCTCTCTA -> AACCTCTCTAA
TAACGGGCAGA -> AACGGGCAGAA
TAACTTCTAGC -> AACTTCTAGCA
TAACTTGACGT -> AACTTGACGTG
TAAGAAAAAAT -> AAGAAAAAATA
TAAGAGAGTAA -> AAGAGAGTAAA
TAAGATATAGC -> AAGATATAGCC
TAAGGGTAGTG -> AAGGGTAGTGA
TAAGGTCTGAC -> AAGGTCTGACG
TAAGTTCACTC -> AAGTTCACTCT
TAAGTTGTTGG -> AAGTTGTTGGC
TAATAGAGATG -> AATAGAGATGA
TAATAGTGCGC -> AATAGTGCGCC
TAATCATGCGA -> AATCATGCGAA
TAATTACTGTA -> AATTACTGTAA
TACAATGGCTA -> ACAATGGCTAA
TACACCTGATT -> ACACCTGATTT
TACACGTACGA -> ACACGTACGAA
TACAGAATCCT -> ACAGAATCCTT
TACAGCTTCGC -> ACAGCTTCGCA
TACAGTGAAAC -> ACAGTGAAACC
TACATTACCCT -> ACATTACCCTC
TACCAAGACTC -> ACCAAGACTCT
TACCAGCACTT -> ACCAGCACTTC
TACCCAACCCT -> ACCCAACCCTT
TACCCAATAAT -> ACCCAATAATA
TACCCTCAGAC -> ACCCTCAGACC
TACCCTCTATA -> ACCCTCTATAT
TACCGCGTAGA -> ACCGCGTAGAA
TACCGGTAATT -> ACCGGTAATTA
TACGAAACCGT -> ACGAAACCGTG
TACGAATCACC -> ACGAATCACCC
TACGAGTACTC -> ACGAGTACTCT
TACGATGTACG -> ACGATGTACGA
TACGATTATTA -> ACGATTATTAC
TACGCCGCGTA -> ACGCCGCGTAT
TACGTTAAATC -> ACGTTAAATCT
TACGTTGAGGA -> ACGTTGAGGAG
TACTACCCTCT -> ACTACCCTCTA
TACTAGTGTGG -> ACTAGTGTGGG
TACTCGGCGAT -> ACTCGGCGATC
TACTCTTCTAA -> ACTCTTCTAAG
TACTGGAGCAT -> ACTGGAGCATG
TACTGTAACAG -> ACTGTAACAGC
TACTTCGTACA -> ACTTCGTACAT
TAGAAATATTA -> AGAAATATTAT
TAGAAATTGGA -> AGAAATTGGAA
TAGAACACAGC -> AGAACACAGCG
TAGAACTAACA -> AGAACTAACAC
TAGAAGGGGGG -> AGAAGGGGGGT
TAGAGATGATG -> AGAGATGATGC
TAGAGCCGTGT -> AGAGCCGTGTC
TAGATTTGCTT -> AGATTTGCTTC
TAGCAAAGCTT -> AGCAAAGCTTT
TAGCAAGAGCG -> AGCAAGAGCGG
TAGCAGAAGGT -> AGCAGAAGGTT
TAGCATGGTGT -> AGCATGGTGTG
TAGCCCACGAT -> AGCCCACGATG
TAGCCCAGCGG -> AGCCCAGCGGC
TAGCGAACACC -> AGCGAACACCG
TAGCGATTCAT -> AGCGATTCATC
TAGCGGATAGC -> AGCGGATAGCG
TAGCTAGAGCC -> AGCTAGAGCCG
TAGGAAGAGGA -> AGGAAGAGGAC
TAGGCGACTCT -> AGGCGACTCTC
TAGGGAGGTGC -> AGGGAGGTGCG
TAGGTCAGGCG -> AGGTCAGGCGG
TAGGTTCACTA -> AGGTTCACTAT
TAGTGAGGAAC -> AGTGAGGAACA
TAGTGCGCCTT -> AGTGCGCCTTC
TAGTGTGGGAT -> AGTGTGGGATA
TAGTTCACCAC -> AGTTCACCACT
TAGTTGTCATT -> AGTTGTCATTA
TATACGTTAAA -> ATACGTTAAAT
TATAGAACTAA -> ATAGAACTAAC
TATAGATTTGC -> ATAGATTTGCT
TATAGCCCAGC -> ATAGCCCAGCG
TATAGGTTCAC -> ATAGGTTCACT
TATAGTTGTCA -> ATAGTTGTCAT
TATATAGAACT -> ATATAGAACTA
TATATAGGTTC -> ATATAGGTTCA
TATATCTCCTC -> ATATCTCCTCA
TATATTTCGGT -> ATATTTCGGTA
TATCATGTAAA -> ATCATGTAAAC
TATCCAGGAGA -> ATCCAGGAGAC
TATCCTCAAAA -> ATCCTCAAAAT
TATCGAATCCC -> ATCGAATCCCG
TATCGCTGAGA -> ATCGCTGAGAG
TATCGGTATCG -> ATCGGTATCGT
TATCGTCGCTC -> ATCGTCGCTCG
TATCTACGCCG -> ATCTACGCCGC
TATCTAGCGAT -> ATCTAGCGATT
TATCTATTCAC -> ATCTATTCACC
TATCTCCTCAG -> ATCTCCTCAGC
TATCTCTCCAA -> ATCTCTCCAAT
TATCTGACGCC -> ATCTGACGCCC
TATCTTTATTT -> ATCTTTATTTC
TATGAGCGGCT -> ATGAGCGGCTC
TATGCACGGCG -> ATGCACGGCGA
TATGCACGTGT -> ATGCACGTGTT
TATGCCACTAA -> ATGCCACTAAA
TATGCGAATTA -> ATGCGAATTAC
TATGGCACTGG -> ATGGCACTGGC
TATGTATGCAC -> ATGTATGCACG
TATTACAGAAT -> ATTACAGAATC
TATTACTCGGC -> ATTACTCGGCG
TATTATGTATG -> ATTATGTATGC
TATTCACCCGA -> ATTCACCCGAC
TATTGATCTAT -> ATTGATCTATC
TATTGGCTGTG -> ATTGGCTGTGA
TATTTCACCAG -> ATTTCACCAGA
TATTTCCTAGC -> ATTTCCTAGCC
TATTTCCTCGT -> ATTTCCTCGTT
TATTTCGGTAC -> ATTTCGGTACA
TATTTGTTATC -> ATTTGTTATCT
TCAAAATACAA -> CAAAATACAAT
TCAAAGCTGGT -> CAAAGCTGGTT
TCAACACCTGA -> CAACACCTGAC
TCAAGGAGTAA -> CAAGGAGTAAA
TCAATCGCGCA -> CAATCGCGCAA
TCACCAAGGAC -> CACCAAGGACG
TCACCAAGGTT -> CACCAAGGTTT
TCACCACTAGG -> CACCACTAGGC
TCACCAGAAGC -> CACCAGAAGCT
TCACCCGACAC -> CACCCGACACG
TCACCCGACCT -> CACCCGACCTG
TCACCTTACAG -> CACCTTACAGT
TCACGCGAGAG -> CACGCGAGAGA
TCACGCGGGTA -> CACGCGGGTAA
TCACTATCGAA -> CACTATCGAAT
TCACTCTTTCC -> CACTCTTTCCT
TCAGACCCCTC -> CAGACCCCTCT
TCAGCCGAAGA -> CAGCCGAAGAA
TCAGCTCGAAT -> CAGCTCGAATG
TCAGGCGGTCC -> CAGGCGGTCCA
TCAGGTTTGCT -> CAGGTTTGCTG
TCAGTTATTTG -> CAGTTATTTGT
TCATATCTGAC -> CATATCTGACG
TCATCACGCGG -> CATCACGCGGG
TCATCGCCACC -> CATCGCCACCA
TCATCTACTTC -> CATCTACTTCG
TCATGAGTAGG -> CATGAGTAGGG
TCATGCGAAGT -> CATGCGAAGTG
TCATGGAAGCA -> CATGGAAGCAA
TCATGTAAACG -> CATGTAAACGG
TCATGTGCGAC -> CATGTGCGACC
TCATTATCTCT -> CATTATCTCTC
TCATTATTACT -> CATTATTACTC
TCCAAATCGAA -> CCAAATCGAAT
TCCAATCCTGG -> CCAATCCTGGG
TCCAGGAGACC -> CCAGGAGACCT
TCCAGTATATA -> CCAGTATATAG
TCCATAGCATG -> CCATAGCATGG
TCCATGTTCCC -> CCATGTTCCCC
TCCCAAGGTCC -> CCCAAGGTCCG
TCCCCAATGTT -> CCCCAATGTTC
TCCCCTTACCA -> CCCCTTACCAA
TCCCGAGAGAT -> CCCGAGAGATA
TCCCTATCTTT -> CCCTATCTTTA
TCCGAACACCC -> CCGAACACCCG
TCCGATGGAAC -> CCGATGGAACC
TCCGCGACCGG -> CCGCGACCGGT
TCCTAAGAAAA -> CCTAAGAAAAA
TCCTAAGATAT -> CCTAAGATATA
TCCTACAGCTT -> CCTACAGCTTC
TCCTAGCCCAC -> CCTAGCCCACG
TCCTCAAAATA -> CCTCAAAATAC
TCCTCAGCCGA -> CCTCAGCCGAA
TCCTCGTAAAA -> CCTCGTAAAAA
TCCTCGTTGAT -> CCTCGTTGATC
TCCTCTCTACT -> CCTCTCTACTG
TCCTGACTATA -> CCTGACTATAC
TCCTGGGAAGG -> CCTGGGAAGGT
TCCTTACTAGT -> CCTTACTAGTG
TCCTTCGTTAT -> CCTTCGTTATC
TCGAAGTATGA -> CGAAGTATGAG
TCGAATAGAAG -> CGAATAGAAGG
TCGAATCCCGA -> CGAATCCCGAG
TCGAATGGTGG -> CGAATGGTGGG
TCGAGCGACGT -> CGAGCGACGTG
TCGAGCGGAAC -> CGAGCGGAACA
TCGATGTTCCA -> CGATGTTCCAT
TCGCAACTAAC -> CGCAACTAACA
TCGCACGTAGG -> CGCACGTAGGT
TCGCAGAAGCC -> CGCAGAAGCCC
TCGCCACCAAG -> CGCCACCAAGC
TCGCGCAACCC -> CGCGCAACCCG
TCGCTCGGTCA -> CGCTCGGTCAG
TCGCTGAGAGG -> CGCTGAGAGGT
TCGGCGATCTT -> CGGCGATCTTC
TCGGCGGTATA -> CGGCGGTATAT
TCGGGACAGTT -> CGGGACAGTTT
TCGGGGACGTC -> CGGGGACGTCA
TCGGTACACCT -> CGGTACACCTG
TCGGTATCGTC -> CGGTATCGTCG
TCGGTCAGGTT -> CGGTCAGGTTT
TCGGTCTGTAA -> CGGTCTGTAAG
TCGGTGTCATT -> CGGTGTCATTA
TCGGTTTAAGT -> CGGTTTAAGTT
TCGTAAAAAAA -> CGTAAAAAAAG
TCGTACATTAC -> CGTACATTACC
TCGTCGCTCGG -> CGTCGCTCGGT
TCGTTATCCAG -> CGTTATCCAGG
TCGTTGATCCC -> CGTTGATCCCT
TCTAAACATAT -> CTAAACATATC
TCTAAGAGAGT -> CTAAGAGAGTA
TCTAATCATGC -> CTAATCATGCG
TCTACGCCGCG -> CTACGCCGCGT
TCTACGTTGAG -> CTACGTTGAGG
TCTACTACCCT -> CTACTACCCTC
TCTACTGGAGC -> CTACTGGAGCA
TCTACTTCGTA -> CTACTTCGTAC
TCTAGCAAGAG -> CTAGCAAGAGC
TCTAGCGATTC -> CTAGCGATTCA
TCTATATAGAA -> CTATATAGAAC
TCTATATCTCC -> CTATATCTCCT
TCTATCCTCAA -> CTATCCTCAAA
TCTATCTATTC -> CTATCTATTCA
TCTATTCACCC -> CTATTCACCCG
TCTCACCTTAC -> CTCACCTTACA
TCTCCAATCCT -> CTCCAATCCTG
TCTCCGATGGA -> CTCCGATGGAA
TCTCCTCAGCC -> CTCCTCAGCCG
TCTCGAAGTAT -> CTCGAAGTATG
TCTCGGTCTGT -> CTCGGTCTGTA
TCTCTAATCAT -> CTCTAATCATG
TCTCTACTGGA -> CTCTACTGGAG
TCTCTCCAATC -> CTCTCCAATCC
TCTGAAAGCAC -> CTGAAAGCACC
TCTGACAATGT -> CTGACAATGTA
TCTGACGACTC -> CTGACGACTCT
TCTGACGCCCA -> CTGACGCCCAG
TCTGATAAAGC -> CTGATAAAGCA
TCTGATGGGGT -> CTGATGGGGTT
TCTGCGGTAAC -> CTGCGGTAACT
TCTGCGTCCCA -> CTGCGTCCCAA
TCTGTAAGTTC -> CTGTAAGTTCA
TCTGTCCCCAA -> CTGTCCCCAAT
TCTGTTCCTGA -> CTGTTCCTGAC
TCTTACGAGTA -> CTTACGAGTAC
TCTTCATATCT -> CTTCATATCTG
TCTTCTAAGAG -> CTTCTAAGAGA
TCTTCTCGGTC -> CTTCTCGGTCT
TCTTGTGCACC -> CTTGTGCACCC
TCTTTATTTCC -> CTTTATTTCCT
TCTTTCCTTCG -> CTTTCCTTCGT
TGAAAAATTCA -> GAAAAATTCAG
TGAAACCGACG -> GAAACCGACGT
TGAAAGCACCG -> GAAAGCACCGT
TGAACAGAGAG -> GAACAGAGAGA
TGAAGAGGAGA -> GAAGAGGAGAG
TGAATGTGTGC -> GAATGTGTGCC
TGACAATGTAT -> GACAATGTATA
TGACAGTGTAT -> GACAGTGTATT
TGACCCGGAAC -> GACCCGGAACC
TGACGACTCTA -> GACGACTCTAT
TGACGCCCAGC -> GACGCCCAGCC
TGACGGATACC -> GACGGATACCA
TGACGTGAGAA -> GACGTGAGAAT
TGACTATACGT -> GACTATACGTT
TGAGAATTCGC -> GAGAATTCGCA
TGAGAGGTCTA -> GAGAGGTCTAT
TGAGCGGCTCT -> GAGCGGCTCTG
TGAGCTCGGGA -> GAGCTCGGGAC
TGAGGAACATA -> GAGGAACATAG
TGAGGAGGAAC -> GAGGAGGAACT
TGAGTAGGGAG -> GAGTAGGGAGG
TGATAAAGCAG -> GATAAAGCAGA
TGATCATCACG -> GATCATCACGC
TGATCCCTATC -> GATCCCTATCT
TGATCTATCCT -> GATCTATCCTC
TGATGCAGAAG -> GATGCAGAAGC
TGATGGGGTTC -> GATGGGGTTCG
TGATTTCATGG -> GATTTCATGGA
TGCACCCAATA -> GCACCCAATAT
TGCACGGCGAT -> GCACGGCGATA
TGCACGTGTTG -> GCACGTGTTGC
TGCAGAAGCCT -> GCAGAAGCCTC
TGCCACAATCC -> GCCACAATCCT
TGCCACCGACT -> GCCACCGACTG
TGCCACTAAAG -> GCCACTAAAGC
TGCCCGGTGGT -> GCCCGGTGGTC
TGCCGCACGAT -> GCCGCACGATC
TGCCTGTGCGT -> GCCTGTGCGTC
TGCGAAGTGGT -> GCGAAGTGGTG
TGCGAATTACA -> GCGAATTACAC
TGCGACCGCGT -> GCGACCGCGTT
TGCGCCTTCTG -> GCGCCTTCTGC
TGCGCGCACCG -> GCGCGCACCGA
TGCGCGGCCGG -> GCGCGGCCGGG
TGCGCTGCCGC -> GCGCTGCCGCA
TGCGGCCCAAA -> GCGGCCCAAAC
TGCGGTAACTT -> GCGGTAACTTC
TGCGTCCCAAG -> GCGTCCCAAGG
TGCGTCGCAGA -> GCGTCGCAGAA
TGCTAACCCAT -> GCTAACCCATC
TGCTGATCATC -> GCTGATCATCA
TGCTGGACGGC -> GCTGGACGGCG
TGCTGTGAAGA -> GCTGTGAAGAG
TGCTTTATTTC -> GCTTTATTTCA
TGGAAAGTTGC -> GGAAAGTTGCC
TGGAACCGTTA -> GGAACCGTTAA
TGGAAGAATCC -> GGAAGAATCCG
TGGAAGCAAGA -> GGAAGCAAGAA
TGGACGGCGGC -> GGACGGCGGCG
TGGAGCATGCT -> GGAGCATGCTG
TGGCACTGGCG -> GGCACTGGCGG
TGGCAGTTGCG -> GGCAGTTGCGC
TGGCGATCAAG -> GGCGATCAAGG
TGGCGGATCAC -> GGCGGATCACC
TGGCTAACGGG -> GGCTAACGGGC
TGGCTGTGACA -> GGCTGTGACAG
TGGGAAGGTGT -> GGGAAGGTGTC
TGGGATAAAAA -> GGGATAAAAAC
TGGGCCTCACG -> GGGCCTCACGC
TGGGGTTCGAG -> GGGGTTCGAGC
TGGGTCGGTTT -> GGGTCGGTTTA
TGGGTCTCGAA -> GGGTCTCGAAG
TGGTAGCTAGA -> GGTAGCTAGAG
TGGTCAACACC -> GGTCAACACCT
TGGTCTGTCCC -> GGTCTGTCCCC
TGGTGGGTCTC -> GGTGGGTCTCG
TGGTGGTAGCT -> GGTGGTAGCTA
TGGTGTGGGCC -> GGTGTGGGCCT
TGGTTCGGGGA -> GGTTCGGGGAC
TGGTTCTTGTG -> GGTTCTTGTGC
TGTAAACGGTC -> GTAAACGGTCA
TGTAACAGCAC -> GTAACAGCACC
TGTAAGTTCAC -> GTAAGTTCACT
TGTACGAAACC -> GTACGAAACCG
TGTATAGATTT -> GTATAGATTTG
TGTATGCACGG -> GTATGCACGGC
TGTATTGATCT -> GTATTGATCTA
TGTCACCAAGG -> GTCACCAAGGT
TGTCATGAGTA -> GTCATGAGTAG
TGTCATTATCT -> GTCATTATCTC
TGTCATTATTA -> GTCATTATTAC
TGTCCCCAATG -> GTCCCCAATGT
TGTCGAGCGGA -> GTCGAGCGGAA
TGTCTTCATAT -> GTCTTCATATC
TGTGAAGAGGA -> GTGAAGAGGAG
TGTGACAGTGT -> GTGACAGTGTA
TGTGCACCCAA -> GTGCACCCAAT
TGTGCCACAAT -> GTGCCACAATC
TGTGCGACCGC -> GTGCGACCGCG
TGTGCGTCGCA -> GTGCGTCGCAG
TGTGGGATAAA -> GTGGGATAAAA
TGTGGGCCTCA -> GTGGGCCTCAC
TGTGTGCCACA -> GTGTGCCACAA
TGTTATCTAGC -> GTTATCTAGCG
TGTTCCATAGC -> GTTCCATAGCA
TGTTCCCCTTA -> GTTCCCCTTAC
TGTTCCTAAGA -> GTTCCTAAGAT
TGTTCCTGACT -> GTTCCTGACTA
TGTTGCCACCG -> GTTGCCACCGA
TGTTGGCGATC -> GTTGGCGATCA
TTAAATCCTAA -> TAAATCCTAAG
TTAAATCTGAT -> TAAATCTGATA
TTAACCTCTCT -> TAACCTCTCTA
TTAACTTGACG -> TAACTTGACGT
TTAAGTTGTTG -> TAAGTTGTTGG
TTACACGTACG -> TACACGTACGA
TTACAGAATCC -> TACAGAATCCT
TTACAGTGAAA -> TACAGTGAAAC
TTACCAAGACT -> TACCAAGACTC
TTACCCTCAGA -> TACCCTCAGAC
TTACGAGTACT -> TACGAGTACTC
TTACGATTATT -> TACGATTATTA
TTACTAGTGTG -> TACTAGTGTGG
TTACTCGGCGA -> TACTCGGCGAT
TTACTGTAACA -> TACTGTAACAG
TTAGTTCACCA -> TAGTTCACCAC
TTATAGTTGTC -> TATAGTTGTCA
TTATCATGTAA -> TATCATGTAAA
TTATCCAGGAG -> TATCCAGGAGA
TTATCTAGCGA -> TATCTAGCGAT
TTATCTCTCCA -> TATCTCTCCAA
TTATGCACGTG -> TATGCACGTGT
TTATGTATGCA -> TATGTATGCAC
TTATTACAGAA -> TATTACAGAAT
TTATTACTCGG -> TATTACTCGGC
TTATTGGCTGT -> TATTGGCTGTG
TTATTTCACCA -> TATTTCACCAG
TTATTTCCTAG -> TATTTCCTAGC
TTATTTGTTAT -> TATTTGTTATC
TTCACCACTAG -> TCACCACTAGG
TTCACCAGAAG -> TCACCAGAAGC
TTCACCCGACA -> TCACCCGACAC
TTCACTATCGA -> TCACTATCGAA
TTCACTCTTTC -> TCACTCTTTCC
TTCAGCTCGAA -> TCAGCTCGAAT
TTCAGTTATTT -> TCAGTTATTTG
TTCATATCTGA -> TCATATCTGAC
TTCATCTACTT -> TCATCTACTTC
TTCATGGAAGC -> TCATGGAAGCA
TTCCATAGCAT -> TCCATAGCATG
TTCCCCTTACC -> TCCCCTTACCA
TTCCTAAGATA -> TCCTAAGATAT
TTCCTAGCCCA -> TCCTAGCCCAC
TTCCTCGTTGA -> TCCTCGTTGAT
TTCCTGACTAT -> TCCTGACTATA
TTCCTTCGTTA -> TCCTTCGTTAT
TTCGAGCGACG -> TCGAGCGACGT
TTCGCAACTAA -> TCGCAACTAAC
TTCGCACGTAG -> TCGCACGTAGG
TTCGGCGGTAT -> TCGGCGGTATA
TTCGGGGACGT -> TCGGGGACGTC
TTCGGTACACC -> TCGGTACACCT
TTCGGTGTCAT -> TCGGTGTCATT
TTCGTACATTA -> TCGTACATTAC
TTCGTTATCCA -> TCGTTATCCAG
TTCTAAGAGAG -> TCTAAGAGAGT
TTCTAGCAAGA -> TCTAGCAAGAG
TTCTCCGATGG -> TCTCCGATGGA
TTCTCGGTCTG -> TCTCGGTCTGT
TTCTGATGGGG -> TCTGATGGGGT
TTCTGCGTCCC -> TCTGCGTCCCA
TTCTTACGAGT -> TCTTACGAGTA
TTCTTGTGCAC -> TCTTGTGCACC
TTGAAAAATTC -> TGAAAAATTCA
TTGAACAGAGA -> TGAACAGAGAG
TTGACGTGAGA -> TGACGTGAGAA
TTGAGGAGGAA -> TGAGGAGGAAC
TTGATCCCTAT -> TGATCCCTATC
TTGATCTATCC -> TGATCTATCCT
TTGCCACCGAC -> TGCCACCGACT
TTGCCTGTGCG -> TGCCTGTGCGT
TTGCGCGGCCG -> TGCGCGGCCGG
TTGCTGGACGG -> TGCTGGACGGC
TTGGAAAGTTG -> TGGAAAGTTGC
TTGGAAGAATC -> TGGAAGAATCC
TTGGCAGTTGC -> TGGCAGTTGCG
TTGGCGATCAA -> TGGCGATCAAG
TTGGCTGTGAC -> TGGCTGTGACA
TTGTCACCAAG -> TGTCACCAAGG
TTGTCATTATC -> TGTCATTATCT
TTGTGCACCCA -> TGTGCACCCAA
TTGTTATCTAG -> TGTTATCTAGC
TTGTTGGCGAT -> TGTTGGCGATC
TTTAAGTTGTT -> TTAAGTTGTTG
TTTAGTTCACC -> TTAGTTCACCA
TTTATCATGTA -> TTATCATGTAA
TTTATTTCACC -> TTATTTCACCA
TTTATTTCCTA -> TTATTTCCTAG
TTTCACCAGAA -> TTCACCAGAAG
TTTCATGGAAG -> TTCATGGAAGC
TTTCCTAGCCC -> TTCCTAGCCCA
TTTCCTCGTTG -> TTCCTCGTTGA
TTTCCTTCGTT -> TTCCTTCGTTA
TTTCGGTACAC -> TTCGGTACACC
TTTCGGTGTCA -> TTCGGTGTCAT
TTTCTGATGGG -> TTCTGATGGGG
TTTGAAAAATT -> TTGAAAAATTC
TTTGCTGGACG -> TTGCTGGACGG
TTTGTCACCAA -> TTGTCACCAAG
TTTGTTATCTA -> TTGTTATCTAG
TTTTAGTTCAC -> TTTAGTTCACC
TTTTATCATGT -> TTTATCATGTA
