AAAAAGAAAC -> AAAAGAAACA
AAAACACAAA -> AAACACAAAC
AAAAGAAACA -> AAAGAAACAA
AAAAGTACCT -> AAAGTACCTC
AAAATGGGTA -> AAATGGGTAT
AAACAACGGG -> AACAACGGGT
AAACACAAAC -> AACACAAACC
AAACAGGAAT -> AACAGGAATA
AAACCGGTAT -> AACCGGTATA
AAACCGGTGG -> AACCGGTGGG
AAACCTCTCT -> AACCTCTCTT
AAACTAACAC -> AACTAACACA
AAACTCACCA -> AACTCACCAA
AAAGAAACAA -> AAGAAACAAC
AAAGACAGCA -> AAGACAGCAC
AAAGCTGAGT -> AAGCTGAGTA
AAAGGCAAAA -> AAGGCAAAAG
AAAGTAAACC -> AAGTAAACCG
AAAGTACCCA -> AAGTACCCAG
AAAGTACCTC -> AAGTACCTCG
AAATACAGAC -> AATACAGACC
AAATACCGGT -> AATACCGGTC
AAATACTGTC -> AATACTGTCC
AAATATTATG -> AATATTATGT
AAATCCCTGT -> AATCCCTGTG
AAATCCCTTT -> AATCCCTTTA
AAATGGGTAT -> AATGGGTATA
AAATTAGACT -> AATTAGACTT
AAATTCTAAC -> AATTCTAACG
AAATTCTGGC -> AATTCTGGCC
AAATTGGTGA -> AATTGGTGAG
AACAAACTCA -> ACAAACTCAC
AACAACGGGT -> ACAACGGGTT
AACAAGCGGG -> ACAAGCGGGC
AACAATTAAA -> ACAATTAAAG
AACACAAACC -> ACACAAACCT
AACACATGCA -> ACACATGCAC
AACACGGGTC -> ACACGGGTCT
AACACGTTCA -> ACACGTTCAA
AACAGATATC -> ACAGATATCG
AACAGGAATA -> ACAGGAATAT
AACAGGTCGA -> ACAGGTCGAG
AACAGTTCCA -> ACAGTTCCAT
AACATGCGAA -> ACATGCGAAT
AACCCACGTA -> ACCCACGTAC
AACCCCAATA -> ACCCCAATAC
AACCCCTCTG -> ACCCCTCTGA
AACCGCCCAG -> ACCGCCCAGT
AACCGGTATA -> ACCGGTATAA
AACCGGTGGG -> ACCGGTGGGG
AACCTCTCTT -> ACCTCTCTTT
AACGATACCA -> ACGATACCAC
AACGCATAAT -> ACGCATAATT
AACGCGCCGC -> ACGCGCCGCG
AACGCTTTTG -> ACGCTTTTGA
AACGGACGTG -> ACGGACGTGT
AACGGAGGGT -> ACGGAGGGTG
AACGGGTTCC -> ACGGGTTCCC
AACGTCGCTT -> ACGTCGCTTA
AACGTGCAAT -> ACGTGCAATG
AACTAACACA -> ACTAACACAT
AACTATTGGA -> ACTATTGGAC
AACTCACCAA -> ACTCACCAAG
AACTTTAGAG -> ACTTTAGAGT
AAGAAAACAC -> AGAAAACACA
AAGAAACAAC -> AGAAACAACG
AAGAAGATCA -> AGAAGATCAA
AAGACAGCAC -> AGACAGCACA
AAGACCCGCA -> AGACCCGCAA
AAGATCAACA -> AGATCAACAA
AAGATGCGTT -> AGATGCGTTC
AAGATTTGCT -> AGATTTGCTA
AAGCACTTCA -> AGCACTTCAC
AAGCAGATCG -> AGCAGATCGC
AAGCAGCGAG -> AGCAGCGAGT
AAGCCTACTG -> AGCCTACTGT
AAGCCTCGGT -> AGCCTCGGTG
AAGCGAAGCC -> AGCGAAGCCT
AAGCGGGCAG -> AGCGGGCAGC
AAGCGTTACT -> AGCGTTACTA
AAGCTGACTC -> AGCTGACTCC
AAGCTGAGTA -> AGCTGAGTAA
AAGCTTAGAA -> AGCTTAGAAA
AAGGATTAAT -> AGGATTAATG
AAGGCAAAAG -> AGGCAAAAGT
AAGGGACATC -> AGGGACATCA
AAGGGGTCTA -> AGGGGTCTAC
AAGTAAACCG -> AGTAAACCGG
AAGTACCCAG -> AGTACCCAGT
AAGTACCTCG -> AGTACCTCGC
AAGTATGTCG -> AGTATGTCGC
AAGTCCTCTT -> AGTCCTCTTG
AAGTCTACTC -> AGTCTACTCG
AAGTGACTGA -> AGTGACTGAG
AAGTGGTACG -> AGTGGTACGA
AAGTGTACCG -> AGTGTACCGA
AAGTGTACTC -> AGTGTACTCT
AAGTTCAAAT -> AGTTCAAATA
AAGTTGACGA -> AGTTGACGAC
AATAACCGCC -> ATAACCGCCC
AATAACGGAG -> ATAACGGAGG
AATACAAATC -> ATACAAATCC
AATACAGACC -> ATACAGACCA
AATACCGGTC -> ATACCGGTCT
AATACTCCGA -> ATACTCCGAG
AATACTGTCC -> ATACTGTCCT
AATATATTAC -> ATATATTACC
AATATGTCGC -> ATATGTCGCT
AATATTATGT -> ATATTATGTC
AATATTCCAG -> ATATTCCAGG
AATCAAATTG -> ATCAAATTGG
AATCAGATCT -> ATCAGATCTA
AATCAGCTTA -> ATCAGCTTAG
AATCCACGTT -> ATCCACGTTA
AATCCCAATC -> ATCCCAATCT
AATCCCTGTG -> ATCCCTGTGA
AATCCCTTTA -> ATCCCTTTAT
AATCCGGAAG -> ATCCGGAAGC
AATCGGCGTC -> ATCGGCGTCT
AATCTCTCCA -> ATCTCTCCAC
AATCTCTTTA -> ATCTCTTTAC
AATCTTGTTT -> ATCTTGTTTT
AATCTTTGAG -> ATCTTTGAGC
AATGCGCGAC -> ATGCGCGACG
AATGCGGCGC -> ATGCGGCGCT
AATGGAACAC -> ATGGAACACG
AATGGGTATA -> ATGGGTATAA
AATGGTCCCT -> ATGGTCCCTG
AATGTCTCAG -> ATGTCTCAGT
AATTAAAGCT -> ATTAAAGCTG
AATTACCTCT -> ATTACCTCTG
AATTAGACTT -> ATTAGACTTA
AATTAGATCT -> ATTAGATCTC
AATTAGTCTA -> ATTAGTCTAA
AATTCAAGCA -> ATTCAAGCAG
AATTCATAAA -> ATTCATAAAT
AATTCGGTAC -> ATTCGGTACT
AATTCTAACG -> ATTCTAACGC
AATTCTGGCC -> ATTCTGGCCG
AATTGGTGAG -> ATTGGTGAGG
ACAAAAAGAA -> CAAAAAGAAA
ACAAACCTCT -> CAAACCTCTC
ACAAACTCAC -> CAAACTCACC
ACAAATCCCT -> CAAATCCCTT
ACAACATGCG -> CAACATGCGA
ACAACGGGTT -> CAACGGGTTC
ACAAGACCCG -> CAAGACCCGC
ACAAGCGGGC -> CAAGCGGGCA
ACAAGCGTTA -> CAAGCGTTAC
ACAAGTCTAC -> CAAGTCTACT
ACAATCAGAT -> CAATCAGATC
ACAATTAAAG -> CAATTAAAGC
ACACAAACCT -> CACAAACCTC
ACACATGCAC -> CACATGCACC
ACACGGGTCT -> CACGGGTCTC
ACACGTAACA -> CACGTAACAG
ACACGTTCAA -> CACGTTCAAC
ACAGACCACA -> CAGACCACAA
ACAGATACTC -> CAGATACTCC
ACAGATATCG -> CAGATATCGC
ACAGATTACC -> CAGATTACCC
ACAGCACAAC -> CAGCACAACA
ACAGGAATAT -> CAGGAATATA
ACAGGGCCTC -> CAGGGCCTCG
ACAGGTCGAG -> CAGGTCGAGT
ACAGTTCAGG -> CAGTTCAGGT
ACAGTTCCAT -> CAGTTCCATA
ACATAAACTA -> CATAAACTAA
ACATCACGCA -> CATCACGCAT
ACATCCACCT -> CATCCACCTT
ACATGCACCA -> CATGCACCAC
ACATGCGAAT -> CATGCGAATA
ACATTCGCGT -> CATTCGCGTT
ACATTCTAAG -> CATTCTAAGT
ACCAAAGACA -> CCAAAGACAG
ACCAAGAAAA -> CCAAGAAAAC
ACCAATCGGC -> CCAATCGGCG
ACCACAAGTC -> CCACAAGTCT
ACCACGAACA -> CCACGAACAC
ACCACTCTAG -> CCACTCTAGT
ACCAGAGGCC -> CCAGAGGCCA
ACCAGATAAG -> CCAGATAAGA
ACCAGTTCTG -> CCAGTTCTGT
ACCCACGTAC -> CCCACGTACG
ACCCAGTGCC -> CCCAGTGCCA
ACCCCAATAC -> CCCCAATACA
ACCCCAATCC -> CCCCAATCCG
ACCCCTCTGA -> CCCCTCTGAC
ACCCCTGCAG -> CCCCTGCAGA
ACCCGCAAAT -> CCCGCAAATC
ACCCTACGCC -> CCCTACGCCC
ACCCTGGTGT -> CCCTGGTGTC
ACCCTTTGCT -> CCCTTTGCTG
ACCGACCATC -> CCGACCATCC
ACCGATATGA -> CCGATATGAA
ACCGCCAAGC -> CCGCCAAGCC
ACCGCCCAGT -> CCGCCCAGTT
ACCGCGTTTT -> CCGCGTTTTA
ACCGGTATAA -> CCGGTATAAT
ACCGGTCTCA -> CCGGTCTCAC
ACCGGTGGAG -> CCGGTGGAGC
ACCGGTGGGG -> CCGGTGGGGA
ACCTCAACGT -> CCTCAACGTC
ACCTCGCGAC -> CCTCGCGACG
ACCTCTCTTT -> CCTCTCTTTA
ACCTCTGATC -> CCTCTGATCT
ACCTTAAGTT -> CCTTAAGTTG
ACCTTGAATG -> CCTTGAATGC
ACCTTTAACT -> CCTTTAACTT
ACGAACACGT -> CGAACACGTT
ACGAACCCCT -> CGAACCCCTC
ACGAAGTGTA -> CGAAGTGTAC
ACGACACGTA -> CGACACGTAA
ACGACCAGAG -> CGACCAGAGG
ACGACCGCCA -> CGACCGCCAA
ACGACTAGGA -> CGACTAGGAG
ACGACTTTAC -> CGACTTTACA
ACGATACCAC -> CGATACCACG
ACGATATAAA -> CGATATAAAG
ACGCATAATT -> CGCATAATTA
ACGCATCGCA -> CGCATCGCAG
ACGCCCCCGG -> CGCCCCCGGC
ACGCCTCAAC -> CGCCTCAACC
ACGCGCCGCG -> CGCGCCGCGC
ACGCTGTACT -> CGCTGTACTC
ACGCTTTTGA -> CGCTTTTGAT
ACGGACGTGT -> CGGACGTGTG
ACGGAGGGTG -> CGGAGGGTGT
ACGGCCGTCC -> CGGCCGTCCA
ACGGGTCTCT -> CGGGTCTCTA
ACGGGTTCCC -> CGGGTTCCCT
ACGTAACAGT -> CGTAACAGTT
ACGTAAGGAT -> CGTAAGGATT
ACGTACGACA -> CGTACGACAC
ACGTCGCTTA -> CGTCGCTTAT
ACGTGCAATG -> CGTGCAATGG
ACGTGTGTTA -> CGTGTGTTAT
ACGTTATGCA -> CGTTATGCAG
ACGTTCAACA -> CGTTCAACAA
ACGTTGACCC -> CGTTGACCCC
ACTAACACAT -> CTAACACATG
ACTACAGTTC -> CTACAGTTCA
ACTACGGCCG -> CTACGGCCGT
ACTAGCTGCA -> CTAGCTGCAT
ACTAGGAGGT -> CTAGGAGGTA
ACTATTGGAC -> CTATTGGACT
ACTCAACAGG -> CTCAACAGGT
ACTCACCAAG -> CTCACCAAGA
ACTCCCGACT -> CTCCCGACTG
ACTCCGAGGA -> CTCCGAGGAG
ACTCCGGCGT -> CTCCGGCGTC
ACTCGAGAAT -> CTCGAGAATG
ACTCGCGAAC -> CTCGCGAACA
ACTCTAATAT -> CTCTAATATG
ACTCTAATCT -> CTCTAATCTT
ACTCTAGTGC -> CTCTAGTGCT
ACTGAGAGGG -> CTGAGAGGGT
ACTGGACTAC -> CTGGACTACG
ACTGTAAGCT -> CTGTAAGCTT
ACTGTAGGAG -> CTGTAGGAGT
ACTGTCACTA -> CTGTCACTAC
ACTGTCCTCC -> CTGTCCTCCG
ACTTACAGGG -> CTTACAGGGC
ACTTAGGAGG -> CTTAGGAGGG
ACTTCACATA -> CTTCACATAA
ACTTCTAGCG -> CTTCTAGCGA
ACTTGGACCA -> CTTGGACCAA
ACTTGGGAAC -> CTTGGGAACG
ACTTTACAAT -> CTTTACAATC
ACTTTACATT -> CTTTACATTC
ACTTTAGAGT -> CTTTAGAGTC
AGAAAACACA -> GAAAACACAA
AGAAACAACG -> GAAACAACGG
AGAAATATTA -> GAAATATTAT
AGAACGTGCA -> GAACGTGCAA
AGAAGATCAA -> GAAGATCAAC
AGAATGCGGC -> GAATGCGGCG
AGACAGATTA -> GACAGATTAC
AGACAGCACA -> GACAGCACAA
AGACCACAAG -> GACCACAAGT
AGACCCGCAA -> GACCCGCAAA
AGACTTACAG -> GACTTACAGG
AGACTTTACA -> GACTTTACAA
AGAGGCCAGT -> GAGGCCAGTG
AGAGGGTCCC -> GAGGGTCCCT
AGAGGTAATC -> GAGGTAATCA
AGAGTCGCGG -> GAGTCGCGGA
AGATAAACCG -> GATAAACCGG
AGATAACGCA -> GATAACGCAT
AGATAAGATT -> GATAAGATTT
AGATACGCTG -> GATACGCTGT
AGATACTCCG -> GATACTCCGG
AGATATCGCC -> GATATCGCCC
AGATCAACAA -> GATCAACAAG
AGATCGCGTT -> GATCGCGTTG
AGATCTAGTG -> GATCTAGTGT
AGATCTCGGG -> GATCTCGGGT
AGATGCGTTC -> GATGCGTTCG
AGATGGGAAT -> GATGGGAATG
AGATGGGATC -> GATGGGATCA
AGATTACCCT -> GATTACCCTT
AGATTTGCTA -> GATTTGCTAT
AGCAAAATGG -> GCAAAATGGG
AGCACAACAT -> GCACAACATG
AGCACTTCAC -> GCACTTCACA
AGCAGATCGC -> GCAGATCGCG
AGCAGCGAGT -> GCAGCGAGTA
AGCATCCTTG -> GCATCCTTGG
AGCCCACAAG -> GCCCACAAGC
AGCCTACTGT -> GCCTACTGTC
AGCCTCGGTG -> GCCTCGGTGC
AGCGAAGCCT -> GCGAAGCCTA
AGCGAAGTCC -> GCGAAGTCCT
AGCGAATTAG -> GCGAATTAGT
AGCGAGATAC -> GCGAGATACG
AGCGAGTACC -> GCGAGTACCG
AGCGCGAGTG -> GCGCGAGTGT
AGCGCGCAAG -> GCGCGCAAGG
AGCGCGCGCT -> GCGCGCGCTT
AGCGGGCAGC -> GCGGGCAGCT
AGCGTTACTA -> GCGTTACTAG
AGCTCTGGAC -> GCTCTGGACC
AGCTGACTCC -> GCTGACTCCC
AGCTGAGTAA -> GCTGAGTAAA
AGCTGCATAC -> GCTGCATACA
AGCTGCATGA -> GCTGCATGAG
AGCTGTATTG -> GCTGTATTGA
AGCTTAGAAA -> GCTTAGAAAT
AGCTTAGTCC -> GCTTAGTCCA
AGCTTATAAC -> GCTTATAACT
AGCTTTTCAA -> GCTTTTCAAA
AGGAATATAT -> GGAATATATT
AGGACGAACC -> GGACGAACCC
AGGACTGTAG -> GGACTGTAGG
AGGAGATAAA -> GGAGATAAAC
AGGAGGGGGG -> GGAGGGGGGT
AGGAGGGTCG -> GGAGGGTCGC
AGGAGGTAGT -> GGAGGTAGTT
AGGAGTGCGT -> GGAGTGCGTT
AGGATAATAC -> GGATAATACT
AGGATTAATG -> GGATTAATGG
AGGCAAAAGT -> GGCAAAAGTA
AGGCAACCCC -> GGCAACCCCA
AGGCCAGTGA -> GGCCAGTGAA
AGGCGAGTAG -> GGCGAGTAGC
AGGGACATCA -> GGGACATCAC
AGGGCCTCGT -> GGGCCTCGTA
AGGGGGGTTT -> GGGGGGTTTG
AGGGGTCTAC -> GGGGTCTACG
AGGGTCCCTA -> GGGTCCCTAC
AGGGTCGCGA -> GGGTCGCGAG
AGGGTGTTTA -> GGGTGTTTAA
AGGTAATCAG -> GGTAATCAGC
AGGTAGTTGT -> GGTAGTTGTA
AGGTATACCC -> GGTATACCCC
AGGTCCGACA -> GGTCCGACAA
AGGTCGAGTC -> GGTCGAGTCG
AGTAAACCGG -> GTAAACCGGT
AGTAAATTAG -> GTAAATTAGA
AGTAAGGGGT -> GTAAGGGGTC
AGTACCCAGT -> GTACCCAGTG
AGTACCGCGT -> GTACCGCGTT
AGTACCTCGC -> GTACCTCGCG
AGTAGCTCTG -> GTAGCTCTGG
AGTATGTCGC -> GTATGTCGCC
AGTATTATAA -> GTATTATAAT
AGTCAAGTGA -> GTCAAGTGAC
AGTCAATCTC -> GTCAATCTCT
AGTCATTGTG -> GTCATTGTGG
AGTCCAAGAA -> GTCCAAGAAG
AGTCCCATGC -> GTCCCATGCA
AGTCCTCTTG -> GTCCTCTTGT
AGTCGCCCGG -> GTCGCCCGGA
AGTCGCGGAA -> GTCGCGGAAG
AGTCTAAACA -> GTCTAAACAG
AGTCTACTCG -> GTCTACTCGA
AGTGAACGAT -> GTGAACGATA
AGTGACCGGT -> GTGACCGGTG
AGTGACTGAG -> GTGACTGAGA
AGTGCATCTC -> GTGCATCTCC
AGTGCCAATA -> GTGCCAATAA
AGTGCGTTGT -> GTGCGTTGTG
AGTGCTTTAT -> GTGCTTTATT
AGTGGTACGA -> GTGGTACGAC
AGTGTACCGA -> GTGTACCGAC
AGTGTACTCT -> GTGTACTCTA
AGTGTACTTA -> GTGTACTTAG
AGTGTCCATA -> GTGTCCATAT
AGTGTTCGTA -> GTGTTCGTAC
AGTTCAAATA -> GTTCAAATAC
AGTTCAGGTC -> GTTCAGGTCC
AGTTCCATAT -> GTTCCATATG
AGTTCCTTAC -> GTTCCTTACC
AGTTCTGTTG -> GTTCTGTTGA
AGTTGACGAC -> GTTGACGACT
AGTTGCTCGT -> GTTGCTCGTA
AGTTGTAGCA -> GTTGTAGCAA
AGTTTAAATT -> GTTTAAATTC
AGTTTCTGAA -> GTTTCTGAAC
ATAAACCGGT -> TAAACCGGTA
ATAAACTAAC -> TAAACTAACA
ATAAAGTAAA -> TAAAGTAAAC
ATAAATTCTG -> TAAATTCTGG
ATAACCGCCC -> TAACCGCCCA
ATAACGCATA -> TAACGCATAA
ATAACGCTTT -> TAACGCTTTT
ATAACGGAGG -> TAACGGAGGG
ATAACTATTG -> TAACTATTGG
ATAAGATTTG -> TAAGATTTGC
ATAAGCTGAC -> TAAGCTGACT
ATAAGTATGT -> TAAGTATGTC
ATAATACTCC -> TAATACTCCG
ATAATCCACG -> TAATCCACGT
ATAATCTTGT -> TAATCTTGTT
ATAATTACCT -> TAATTACCTC
ATAATTCGGT -> TAATTCGGTA
ATACAAATCC -> TACAAATCCC
ATACAGACCA -> TACAGACCAC
ATACATTCTA -> TACATTCTAA
ATACCACGAA -> TACCACGAAC
ATACCCCTGC -> TACCCCTGCA
ATACCGGTCT -> TACCGGTCTC
ATACGACTAG -> TACGACTAGG
ATACGCTGTA -> TACGCTGTAC
ATACTCAACA -> TACTCAACAG
ATACTCCGAG -> TACTCCGAGG
ATACTCCGGC -> TACTCCGGCG
ATACTGTCCT -> TACTGTCCTC
ATAGCATCCT -> TAGCATCCTT
ATAGGAGGGG -> TAGGAGGGGG
ATAGTCCCAT -> TAGTCCCATG
ATAGTTTCTG -> TAGTTTCTGA
ATATAAAGTA -> TATAAAGTAA
ATATACGACT -> TATACGACTA
ATATATTACC -> TATATTACCT
ATATCGCCCG -> TATCGCCCGA
ATATGAATTA -> TATGAATTAG
ATATGCGCTG -> TATGCGCTGC
ATATGTACCC -> TATGTACCCT
ATATGTCGCT -> TATGTCGCTT
ATATTACCTT -> TATTACCTTA
ATATTATGTC -> TATTATGTCG
ATATTCCAGG -> TATTCCAGGA
ATCAAAGTAC -> TCAAAGTACC
ATCAAATTGG -> TCAAATTGGT
ATCAACAAGC -> TCAACAAGCG
ATCACGCATC -> TCACGCATCG
ATCAGATCTA -> TCAGATCTAG
ATCAGCTTAG -> TCAGCTTAGT
ATCATAGGAG -> TCATAGGAGG
ATCCACCTTG -> TCCACCTTGA
ATCCACGTTA -> TCCACGTTAT
ATCCACTTGG -> TCCACTTGGG
ATCCCAATCT -> TCCCAATCTC
ATCCCTGTGA -> TCCCTGTGAA
ATCCCTTTAT -> TCCCTTTATA
ATCCGACGAC -> TCCGACGACC
ATCCGGAAGC -> TCCGGAAGCA
ATCCTTGGAT -> TCCTTGGATG
ATCGCAGCCC -> TCGCAGCCCA
ATCGCCCGAA -> TCGCCCGAAT
ATCGCGTTGA -> TCGCGTTGAT
ATCGGCGTCT -> TCGGCGTCTG
ATCGTGTGTT -> TCGTGTGTTA
ATCTAGTGTT -> TCTAGTGTTC
ATCTCCCCGC -> TCTCCCCGCG
ATCTCGGGTT -> TCTCGGGTTA
ATCTCTCCAC -> TCTCTCCACG
ATCTCTTTAC -> TCTCTTTACT
ATCTGTGAAG -> TCTGTGAAGC
ATCTTGTTTT -> TCTTGTTTTT
ATCTTTGAGC -> TCTTTGAGCT
ATGAATTAGA -> TGAATTAGAT
ATGAGATGGG -> TGAGATGGGA,TGAGATGGGA
ATGAGTTGCT -> TGAGTTGCTC
ATGATGAGAT -> TGATGAGATG
ATGCACCACT -> TGCACCACTC
ATGCAGCGCG -> TGCAGCGCGC
ATGCAGCTTA -> TGCAGCTTAT
ATGCGAATAA -> TGCGAATAAC
ATGCGCGACG -> TGCGCGACGA
ATGCGCTGCT -> TGCGCTGCTT
ATGCGGCGCT -> TGCGGCGCTA
ATGCGTTCGT -> TGCGTTCGTC
ATGGAACACG -> TGGAACACGG
ATGGGAATGT -> TGGGAATGTC
ATGGGATCAT -> TGGGATCATA
ATGGGCTGTG -> TGGGCTGTGC
ATGGGTATAA -> TGGGTATAAT
ATGGTCCCTG -> TGGTCCCTGA
ATGTACCCTA -> TGTACCCTAC
ATGTCGCATG -> TGTCGCATGA
ATGTCGCCGG -> TGTCGCCGGA
ATGTCGCTTA -> TGTCGCTTAG
ATGTCTCAGT -> TGTCTCAGTA
ATTAAAGCTG -> TTAAAGCTGA
ATTAATCCCA -> TTAATCCCAA
ATTAATGGTC -> TTAATGGTCC
ATTACCCTTT -> TTACCCTTTG
ATTACCTCTG -> TTACCTCTGA
ATTACCTTAA -> TTACCTTAAG
ATTAGAACGT -> TTAGAACGTG
ATTAGACTTA -> TTAGACTTAC
ATTAGATCTC -> TTAGATCTCG
ATTAGGTATA -> TTAGGTATAC
ATTAGTCTAA -> TTAGTCTAAA
ATTAGTGCAT -> TTAGTGCATC
ATTATAATCT -> TTATAATCTT
ATTATGTCGC -> TTATGTCGCA
ATTCAAGCAG -> TTCAAGCAGA
ATTCAGATAA -> TTCAGATAAC
ATTCATAAAT -> TTCATAAATT
ATTCCACCAA -> TTCCACCAAA
ATTCCAGGAT -> TTCCAGGATA
ATTCCGAGAG -> TTCCGAGAGG
ATTCGCGTTA -> TTCGCGTTAC
ATTCGGTACT -> TTCGGTACTT
ATTCTAACGC -> TTCTAACGCG
ATTCTAAGTG -> TTCTAAGTGT
ATTCTGGCCG -> TTCTGGCCGA
ATTGACCAGT -> TTGACCAGTT
ATTGCCTCTG -> TTGCCTCTGG
ATTGCGGCCA -> TTGCGGCCAG
ATTGGACTGT -> TTGGACTGTA
ATTGGGCCCC -> TTGGGCCCCG
ATTGGTGAGG -> TTGGTGAGGC
ATTGTGGCCA -> TTGTGGCCAT
ATTTCGAAAT -> TTTCGAAATA
ATTTGCTATT -> TTTGCTATTA
CAAAAAGAAA -> AAAAAGAAAC
CAAAAGTACC -> AAAAGTACCT
CAAAATGGGT -> AAAATGGGTA
CAAACCTCTC -> AAACCTCTCT
CAAACTCACC -> AAACTCACCA
CAAAGACAGC -> AAAGACAGCA
CAAAGTACCC -> AAAGTACCCA
CAAATACAGA -> AAATACAGAC
CAAATACTGT -> AAATACTGTC
CAAATCCCTG -> AAATCCCTGT
CAAATCCCTT -> AAATCCCTTT
CAAATTGGTG -> AAATTGGTGA
CAACAAACTC -> AACAAACTCA
CAACAAGCGG -> AACAAGCGGG
CAACAGGTCG -> AACAGGTCGA
CAACATGCGA -> AACATGCGAA
CAACCCACGT -> AACCCACGTA
CAACCCCAAT -> AACCCCAATA
CAACGGGTTC -> AACGGGTTCC
CAACGTCGCT -> AACGTCGCTT
CAAGAAAACA -> AAGAAAACAC
CAAGAAGATC -> AAGAAGATCA
CAAGACCCGC -> AAGACCCGCA
CAAGCAGATC -> AAGCAGATCG
CAAGCAGCGA -> AAGCAGCGAG
CAAGCCTCGG -> AAGCCTCGGT
CAAGCGGGCA -> AAGCGGGCAG
CAAGCGTTAC -> AAGCGTTACT
CAAGGGACAT -> AAGGGACATC
CAAGTCTACT -> AAGTCTACTC
CAAGTGACTG -> AAGTGACTGA
CAATAACCGC -> AATAACCGCC
CAATACAAAT -> AATACAAATC
CAATCAGATC -> AATCAGATCT
CAATCCGGAA -> AATCCGGAAG
CAATCGGCGT -> AATCGGCGTC
CAATCTCTCC -> AATCTCTCCA
CAATCTCTTT -> AATCTCTTTA
CAATGGAACA -> AATGGAACAC
CAATTAAAGC -> AATTAAAGCT
CAATTCATAA -> AATTCATAAA
CACAAACCTC -> ACAAACCTCT
CACAACATGC -> ACAACATGCG
CACAAGCGTT -> ACAAGCGTTA
CACAAGTCTA -> ACAAGTCTAC
CACATAAACT -> ACATAAACTA
CACATGCACC -> ACATGCACCA
CACCAAAGAC -> ACCAAAGACA
CACCAAGAAA -> ACCAAGAAAA
CACCACTCTA -> ACCACTCTAG
CACCTTGAAT -> ACCTTGAATG
CACGAACACG -> ACGAACACGT
CACGCATCGC -> ACGCATCGCA
CACGGGTCTC -> ACGGGTCTCT
CACGTAACAG -> ACGTAACAGT
CACGTACGAC -> ACGTACGACA
CACGTTATGC -> ACGTTATGCA
CACGTTCAAC -> ACGTTCAACA
CACGTTGACC -> ACGTTGACCC
CACTACAGTT -> ACTACAGTTC
CACTCGCGAA -> ACTCGCGAAC
CACTCTAGTG -> ACTCTAGTGC
CACTTCACAT -> ACTTCACATA
CACTTGGGAA -> ACTTGGGAAC
CAGACAGATT -> AGACAGATTA
CAGACCACAA -> AGACCACAAG
CAGAGGCCAG -> AGAGGCCAGT
CAGATAACGC -> AGATAACGCA
CAGATAAGAT -> AGATAAGATT
CAGATACTCC -> AGATACTCCG
CAGATATCGC -> AGATATCGCC
CAGATCGCGT -> AGATCGCGTT
CAGATCTAGT -> AGATCTAGTG
CAGATTACCC -> AGATTACCCT
CAGCACAACA -> AGCACAACAT
CAGCCCACAA -> AGCCCACAAG
CAGCGAGATA -> AGCGAGATAC
CAGCGAGTAC -> AGCGAGTACC
CAGCGCGAGT -> AGCGCGAGTG
CAGCGCGCAA -> AGCGCGCAAG
CAGCTGCATG -> AGCTGCATGA
CAGCTTAGTC -> AGCTTAGTCC
CAGCTTATAA -> AGCTTATAAC
CAGGAATATA -> AGGAATATAT
CAGGACGAAC -> AGGACGAACC
CAGGATAATA -> AGGATAATAC
CAGGGCCTCG -> AGGGCCTCGT
CAGGTCCGAC -> AGGTCCGACA
CAGGTCGAGT -> AGGTCGAGTC
CAGTAAGGGG -> AGTAAGGGGT
CAGTCATTGT -> AGTCATTGTG
CAGTGAACGA -> AGTGAACGAT
CAGTGCCAAT -> AGTGCCAATA
CAGTTCAGGT -> AGTTCAGGTC
CAGTTCCATA -> AGTTCCATAT
CAGTTCCTTA -> AGTTCCTTAC
CAGTTCTGTT -> AGTTCTGTTG
CATAAACTAA -> ATAAACTAAC
CATAAATTCT -> ATAAATTCTG
CATAATTACC -> ATAATTACCT
CATACATTCT -> ATACATTCTA
CATAGGAGGG -> ATAGGAGGGG
CATATGCGCT -> ATATGCGCTG
CATATGTACC -> ATATGTACCC
CATCACGCAT -> ATCACGCATC
CATCCACCTT -> ATCCACCTTG
CATCCTTGGA -> ATCCTTGGAT
CATCGCAGCC -> ATCGCAGCCC
CATCTCCCCG -> ATCTCCCCGC
CATGAGTTGC -> ATGAGTTGCT
CATGATGAGA -> ATGATGAGAT
CATGCACCAC -> ATGCACCACT
CATGCAGCGC -> ATGCAGCGCG
CATGCGAATA -> ATGCGAATAA
CATTAATCCC -> ATTAATCCCA
CATTAGGTAT -> ATTAGGTATA
CATTCGCGTT -> ATTCGCGTTA
CATTCTAAGT -> ATTCTAAGTG
CATTGGGCCC -> ATTGGGCCCC
CATTGTGGCC -> ATTGTGGCCA
CATTTCGAAA -> ATTTCGAAAT
CCAAAGACAG -> CAAAGACAGC
CCAAGAAAAC -> CAAGAAAACA
CCAAGAAGAT -> CAAGAAGATC
CCAAGCCTCG -> CAAGCCTCGG
CCAATAACCG -> CAATAACCGC
CCAATACAAA -> CAATACAAAT
CCAATCCGGA -> CAATCCGGAA
CCAATCGGCG -> CAATCGGCGT
CCAATCTCTT -> CAATCTCTTT
CCACAAGCGT -> CACAAGCGTT
CCACAAGTCT -> CACAAGTCTA
CCACCAAAGA -> CACCAAAGAC
CCACCTTGAA -> CACCTTGAAT
CCACGAACAC -> CACGAACACG
CCACGTACGA -> CACGTACGAC
CCACGTTATG -> CACGTTATGC
CCACGTTGAC -> CACGTTGACC
CCACTCTAGT -> CACTCTAGTG
CCACTTGGGA -> CACTTGGGAA
CCAGAGGCCA -> CAGAGGCCAG
CCAGATAAGA -> CAGATAAGAT
CCAGCGCGAG -> CAGCGCGAGT
CCAGGATAAT -> CAGGATAATA
CCAGTCATTG -> CAGTCATTGT
CCAGTGAACG -> CAGTGAACGA
CCAGTGCCAA -> CAGTGCCAAT
CCAGTTCCTT -> CAGTTCCTTA
CCAGTTCTGT -> CAGTTCTGTT
CCATATGCGC -> CATATGCGCT
CCATATGTAC -> CATATGTACC
CCATGCAGCG -> CATGCAGCGC
CCATTAATCC -> CATTAATCCC
CCATTGGGCC -> CATTGGGCCC
CCCAATACAA -> CCAATACAAA
CCCAATCCGG -> CCAATCCGGA
CCCAATCTCT -> CCAATCTCTT
CCCACAAGCG -> CCACAAGCGT
CCCACGTACG -> CCACGTACGA
CCCAGTGCCA -> CCAGTGCCAA
CCCAGTTCCT -> CCAGTTCCTT
CCCATGCAGC -> CCATGCAGCG
CCCCAATACA -> CCCAATACAA
CCCCAATCCG -> CCCAATCCGG
CCCCCGGCTG -> CCCCGGCTGA
CCCCGCGCGC -> CCCGCGCGCC
CCCCGGCATT -> CCCGGCATTT
CCCCGGCTGA -> CCCGGCTGAG
CCCCTCTGAC -> CCCTCTGACA
CCCCTGCAGA -> CCCTGCAGAC
CCCGAATATT -> CCGAATATTC
CCCGACTGGA -> CCGACTGGAC
CCCGCAAATC -> CCGCAAATCC
CCCGCGCGCC -> CCGCGCGCCT
CCCGGATAAG -> CCGGATAAGT
CCCGGCATTT -> CCGGCATTTC
CCCGGCTGAG -> CCGGCTGAGT
CCCTACATCC -> CCTACATCCA
CCCTACCCTG -> CCTACCCTGG
CCCTACGCCC -> CCTACGCCCC
CCCTCTGACA -> CCTCTGACAG
CCCTGAGTTT -> CCTGAGTTTA
CCCTGCAGAC -> CCTGCAGACA
CCCTGGTGTC -> CCTGGTGTCA
CCCTGTGAAA -> CCTGTGAAAG
CCCTTAAGTG -> CCTTAAGTGG
CCCTTTATAA -> CCTTTATAAG
CCCTTTGCTG -> CCTTTGCTGA
CCGAATATTC -> CGAATATTCC
CCGACAAAAA -> CGACAAAAAG
CCGACCATCC -> CGACCATCCA
CCGACGACCG -> CGACGACCGC
CCGACTGGAC -> CGACTGGACT
CCGAGAGGTA -> CGAGAGGTAA
CCGAGGAGAT -> CGAGGAGATA
CCGATAACGC -> CGATAACGCT
CCGATATGAA -> CGATATGAAT
CCGCAAATCC -> CGCAAATCCC
CCGCCAAGCC -> CGCCAAGCCT
CCGCCCAGTT -> CGCCCAGTTC
CCGCGATGGG -> CGCGATGGGC
CCGCGCGCCT -> CGCGCGCCTG
CCGCGCGGTT -> CGCGCGGTTT
CCGCGTTTTA -> CGCGTTTTAG
CCGGAAGCAC -> CGGAAGCACT
CCGGAGCGCG -> CGGAGCGCGC
CCGGATAAGT -> CGGATAAGTA
CCGGCATTTC -> CGGCATTTCG
CCGGCGTCTA -> CGGCGTCTAC
CCGGCTGAGT -> CGGCTGAGTA
CCGGTATAAT -> CGGTATAATT
CCGGTCTCAC -> CGGTCTCACT
CCGGTGGAGC -> CGGTGGAGCG
CCGGTGGGGA -> CGGTGGGGAT
CCGTATAGTT -> CGTATAGTTT
CCGTCCATTA -> CGTCCATTAA
CCTACATCCA -> CTACATCCAC
CCTACCCTGG -> CTACCCTGGT
CCTACGCCCC -> CTACGCCCCC
CCTACTGTCA -> CTACTGTCAC
CCTCAACCCA -> CTCAACCCAC
CCTCAACGTC -> CTCAACGTCG
CCTCCGTATA -> CTCCGTATAG
CCTCGCGACG -> CTCGCGACGC
CCTCGGTGCG -> CTCGGTGCGT
CCTCGTAGAC -> CTCGTAGACT
CCTCTCTTTA -> CTCTCTTTAT
CCTCTGACAG -> CTCTGACAGA
CCTCTGATCT -> CTCTGATCTG
CCTCTGGTAT -> CTCTGGTATT
CCTCTTGTTG -> CTCTTGTTGG
CCTGAGTTTA -> CTGAGTTTAA
CCTGCAGACA -> CTGCAGACAG
CCTGGGTTCA -> CTGGGTTCAA
CCTGGTGTCA -> CTGGTGTCAT
CCTGTGAAAG -> CTGTGAAAGG
CCTTAAGTGG -> CTTAAGTGGT
CCTTAAGTTG -> CTTAAGTTGA
CCTTACCTCA -> CTTACCTCAA
CCTTGAATGC -> CTTGAATGCG
CCTTGGATGA -> CTTGGATGAG
CCTTTAACTT -> CTTTAACTTT
CCTTTATAAG -> CTTTATAAGC
CCTTTGCTGA -> CTTTGCTGAT
CGAAATACCG -> GAAATACCGG
CGAACAATTA -> GAACAATTAA
CGAACACGTT -> GAACACGTTC
CGAACCCCTC -> GAACCCCTCT
CGAAGCCTAC -> GAAGCCTACT
CGAAGTCCTC -> GAAGTCCTCT
CGAAGTGTAC -> GAAGTGTACC
CGAATAACGG -> GAATAACGGA
CGAATATTCC -> GAATATTCCA
CGAATTAGTC -> GAATTAGTCT
CGACAAAAAG -> GACAAAAAGA
CGACACGTAA -> GACACGTAAC
CGACCAGAGG -> GACCAGAGGC
CGACCATCCA -> GACCATCCAT
CGACCGCCAA -> GACCGCCAAG
CGACGACCGC -> GACGACCGCC
CGACGATATA -> GACGATATAA
CGACGCCTCA -> GACGCCTCAA
CGACTAGGAG -> GACTAGGAGG
CGACTGGACT -> GACTGGACTA
CGACTTTACA -> GACTTTACAT
CGAGAATGCG -> GAGAATGCGG
CGAGAGGTAA -> GAGAGGTAAT
CGAGATACGC -> GAGATACGCT
CGAGGAGATA -> GAGGAGATAA
CGAGGCAACC -> GAGGCAACCC
CGAGTACCGC -> GAGTACCGCG
CGAGTAGCTC -> GAGTAGCTCT
CGAGTCGCCC -> GAGTCGCCCG
CGAGTGTCCA -> GAGTGTCCAT
CGATAACGCT -> GATAACGCTT
CGATACCACG -> GATACCACGA
CGATATAAAG -> GATATAAAGT
CGATATGAAT -> GATATGAATT
CGATGGGCTG -> GATGGGCTGT
CGCAAATCCC -> GCAAATCCCT
CGCAAGGGAC -> GCAAGGGACA
CGCAGCCCAC -> GCAGCCCACA
CGCATAATTA -> GCATAATTAC
CGCATCGCAG -> GCATCGCAGC
CGCATGATGA -> GCATGATGAG
CGCCAAGCCT -> GCCAAGCCTC
CGCCCAGTTC -> GCCCAGTTCC
CGCCCCCGGC -> GCCCCCGGCT
CGCCCGAATA -> GCCCGAATAT
CGCCCGGATA -> GCCCGGATAA
CGCCGCGCGG -> GCCGCGCGGT
CGCCGGAGCG -> GCCGGAGCGC
CGCCTCAACC -> GCCTCAACCC
CGCCTGGGTT -> GCCTGGGTTC
CGCGAACAAT -> GCGAACAATT
CGCGACGATA -> GCGACGATAT
CGCGACGCCT -> GCGACGCCTC
CGCGAGGCAA -> GCGAGGCAAC
CGCGAGTGTC -> GCGAGTGTCC
CGCGATGGGC -> GCGATGGGCT
CGCGCAAGGG -> GCGCAAGGGA
CGCGCCGCGC -> GCGCCGCGCG
CGCGCCTGGG -> GCGCCTGGGT
CGCGCGCCTG -> GCGCGCCTGG
CGCGCGCTTT -> GCGCGCTTTG
CGCGCGGTTT -> GCGCGGTTTG
CGCGCTTTGC -> GCGCTTTGCA
CGCGGAAGTT -> GCGGAAGTTC
CGCGGTTTGT -> GCGGTTTGTT
CGCGTTACCA -> GCGTTACCAG
CGCGTTGATC -> GCGTTGATCC
CGCGTTTTAG -> GCGTTTTAGT
CGCTAGTGAC -> GCTAGTGACC
CGCTGCTTTC -> GCTGCTTTCG
CGCTGTACTC -> GCTGTACTCT
CGCTTAGTCA -> GCTTAGTCAA
CGCTTATAGC -> GCTTATAGCA
CGCTTTGCAG -> GCTTTGCAGC
CGCTTTTGAT -> GCTTTTGATA
CGGAAGCACT -> GGAAGCACTT
CGGAAGTTCA -> GGAAGTTCAA
CGGACGTGTG -> GGACGTGTGT
CGGAGCGCGC -> GGAGCGCGCG
CGGAGGGTGT -> GGAGGGTGTT
CGGATAAGTA -> GGATAAGTAT
CGGCATTTCG -> GGCATTTCGA
CGGCCAGTCA -> GGCCAGTCAT
CGGCCGTCCA -> GGCCGTCCAT
CGGCGCTAGT -> GGCGCTAGTG
CGGCGTCTAC -> GGCGTCTACA
CGGCGTCTGA -> GGCGTCTGAG
CGGCTGAGTA -> GGCTGAGTAT
CGGGCAGCTG -> GGGCAGCTGC
CGGGTCTCTA -> GGGTCTCTAT
CGGGTTATCG -> GGGTTATCGT
CGGGTTCCCT -> GGGTTCCCTA
CGGTACTTGG -> GGTACTTGGA
CGGTATAATT -> GGTATAATTC
CGGTCCAGCG -> GGTCCAGCGC
CGGTCTCACT -> GGTCTCACTC
CGGTGCGTTA -> GGTGCGTTAT
CGGTGGAGCG -> GGTGGAGCGA
CGGTGGGGAT -> GGTGGGGATA
CGGTTTGTTT -> GGTTTGTTTA
CGTAACAGTT -> GTAACAGTTC
CGTAAGGATT -> GTAAGGATTA
CGTACGAAGT -> GTACGAAGTG
CGTACGACAC -> GTACGACACG
CGTAGACTTT -> GTAGACTTTA
CGTATAGTTT -> GTATAGTTTC
CGTATTCCAC -> GTATTCCACC
CGTCCATTAA -> GTCCATTAAT
CGTCCCTTAA -> GTCCCTTAAG
CGTCGCTTAT -> GTCGCTTATA
CGTCTACAAG -> GTCTACAAGA
CGTCTATTAG -> GTCTATTAGT
CGTCTGAGTG -> GTCTGAGTGT
CGTGCAATGG -> GTGCAATGGA
CGTGTGTTAA -> GTGTGTTAAT
CGTGTGTTAT -> GTGTGTTATT
CGTTACCAGA -> GTTACCAGAT
CGTTACTAGC -> GTTACTAGCT
CGTTATGCAG -> GTTATGCAGC
CGTTATTCCG -> GTTATTCCGA
CGTTCAACAA -> GTTCAACAAA
CGTTCGTCCC -> GTTCGTCCCT
CGTTGACCCC -> GTTGACCCCA
CGTTGATCCG -> GTTGATCCGA
CGTTGTGCGG -> GTTGTGCGGT
CGTTTTAGTC -> GTTTTAGTCA
CTAAACAGGA -> TAAACAGGAA
CTAACACATG -> TAACACATGC
CTAACGCGCC -> TAACGCGCCG
CTAAGTGTAC -> TAAGTGTACT
CTAATATGTC -> TAATATGTCG
CTAATCTTTG -> TAATCTTTGA
CTACAAGACC -> TACAAGACCC
CTACAGTTCA -> TACAGTTCAG
CTACATCCAC -> TACATCCACC
CTACCCTGGT -> TACCCTGGTG
CTACGCCCCC -> TACGCCCCCG
CTACGGCCGT -> TACGGCCGTC
CTACGTAAGG -> TACGTAAGGA
CTACTCGAGA -> TACTCGAGAA
CTACTGTCAC -> TACTGTCACT
CTAGCGAAGT -> TAGCGAAGTC
CTAGCTGCAT -> TAGCTGCATA
CTAGGAGGTA -> TAGGAGGTAG
CTAGTGACCG -> TAGTGACCGG
CTAGTGCTTT -> TAGTGCTTTA
CTAGTGTTCG -> TAGTGTTCGT
CTATCCACTT -> TATCCACTTG
CTATTAGAAC -> TATTAGAACG
CTATTAGTGC -> TATTAGTGCA
CTATTGGACT -> TATTGGACTG
CTCAACAGGT -> TCAACAGGTC
CTCAACCCAC -> TCAACCCACG
CTCAACGTCG -> TCAACGTCGC
CTCACCAAGA -> TCACCAAGAA
CTCACTCGCG -> TCACTCGCGA
CTCAGTAAGG -> TCAGTAAGGG
CTCCACGTTG -> TCCACGTTGA
CTCCCCGCGC -> TCCCCGCGCG
CTCCCGACTG -> TCCCGACTGG
CTCCGAGGAG -> TCCGAGGAGA
CTCCGGCGTC -> TCCGGCGTCT
CTCCGTATAG -> TCCGTATAGT
CTCGAGAATG -> TCGAGAATGC
CTCGCGAACA -> TCGCGAACAA
CTCGCGACGC -> TCGCGACGCC
CTCGGGTTAT -> TCGGGTTATC
CTCGGTGCGT -> TCGGTGCGTT
CTCGTAGACT -> TCGTAGACTT
CTCGTATTCC -> TCGTATTCCA
CTCTAATATG -> TCTAATATGT
CTCTAATCTT -> TCTAATCTTT
CTCTAGTGCT -> TCTAGTGCTT
CTCTATCCAC -> TCTATCCACT
CTCTCCACGT -> TCTCCACGTT
CTCTCTTTAT -> TCTCTTTATA
CTCTGACAGA -> TCTGACAGAT
CTCTGATCTG -> TCTGATCTGT
CTCTGGACCT -> TCTGGACCTT
CTCTGGTATT -> TCTGGTATTC
CTCTTGTTGG -> TCTTGTTGGC
CTCTTTACTT -> TCTTTACTTC
CTCTTTATAT -> TCTTTATATA
CTGAACAGAT -> TGAACAGATA
CTGACAGATA -> TGACAGATAC
CTGACTCCCG -> TGACTCCCGA
CTGAGAGGGT -> TGAGAGGGTC
CTGAGTAAAT -> TGAGTAAATT
CTGAGTATTA -> TGAGTATTAT
CTGAGTGTAC -> TGAGTGTACT
CTGAGTTTAA -> TGAGTTTAAA
CTGATCAAAG -> TGATCAAAGT
CTGATCTGTG -> TGATCTGTGA
CTGCAGACAG -> TGCAGACAGA
CTGCATACAT -> TGCATACATT
CTGCATGAGT -> TGCATGAGTT
CTGCTTTCGT -> TGCTTTCGTC
CTGGACCTTT -> TGGACCTTTA
CTGGACTACG -> TGGACTACGG
CTGGCCGATA -> TGGCCGATAA
CTGGGTTCAA -> TGGGTTCAAT
CTGGTATTCA -> TGGTATTCAG
CTGGTGTCAT -> TGGTGTCATT
CTGTAAGCTT -> TGTAAGCTTA
CTGTACTCTA -> TGTACTCTAA
CTGTAGGAGT -> TGTAGGAGTG
CTGTATTGAC -> TGTATTGACC
CTGTCACTAC -> TGTCACTACA
CTGTCCTCCG -> TGTCCTCCGT
CTGTGAAAGG -> TGTGAAAGGC
CTGTGAAGCG -> TGTGAAGCGA
CTGTGCAGGA -> TGTGCAGGAC
CTGTTGAGCT -> TGTTGAGCTT
CTTAAGTGGT -> TTAAGTGGTA
CTTAAGTTGA -> TTAAGTTGAC
CTTACAGGGC -> TTACAGGGCC
CTTACCTCAA -> TTACCTCAAC
CTTAGAAATA -> TTAGAAATAT
CTTAGGAGGG -> TTAGGAGGGT
CTTAGTCAAT -> TTAGTCAATC
CTTAGTCCAA -> TTAGTCCAAG
CTTATAACTA -> TTATAACTAT
CTTATAGCAT -> TTATAGCATC
CTTCACATAA -> TTCACATAAA
CTTCTAGCGA -> TTCTAGCGAA
CTTGAATGCG -> TTGAATGCGC
CTTGGACCAA -> TTGGACCAAT
CTTGGATGAG -> TTGGATGAGA
CTTGGGAACG -> TTGGGAACGG
CTTGTTGGCC -> TTGTTGGCCG
CTTGTTTTTC -> TTGTTTTTCA
CTTTAACTTT -> TTTAACTTTA
CTTTACAATC -> TTTACAATCA
CTTTACATTC -> TTTACATTCG
CTTTACTTCT -> TTTACTTCTA
CTTTAGAGTC -> TTTAGAGTCG
CTTTATAAGC -> TTTATAAGCT
CTTTATATAC -> TTTATATACG
CTTTATTGCG -> TTTATTGCGG
CTTTCGTCTA -> TTTCGTCTAT
CTTTGAGCTG -> TTTGAGCTGT
CTTTGCAGCG -> TTTGCAGCGA
CTTTGCTGAT -> TTTGCTGATC
CTTTTCAAAT -> TTTTCAAATA
CTTTTGATAC -> TTTTGATACT
GAAAACACAA -> AAAACACAAA
GAAACAACGG -> AAACAACGGG
GAAAGGCAAA -> AAAGGCAAAA
GAAATACCGG -> AAATACCGGT
GAAATATTAT -> AAATATTATG
GAACAATTAA -> AACAATTAAA
GAACACGGGT -> AACACGGGTC
GAACACGTTC -> AACACGTTCA
GAACAGATAT -> AACAGATATC
GAACCCCTCT -> AACCCCTCTG
GAACGATACC -> AACGATACCA
GAACGGACGT -> AACGGACGTG
GAACGTGCAA -> AACGTGCAAT
GAAGATCAAC -> AAGATCAACA
GAAGCACTTC -> AAGCACTTCA
GAAGCCTACT -> AAGCCTACTG
GAAGCGAAGC -> AAGCGAAGCC
GAAGTCCTCT -> AAGTCCTCTT
GAAGTGTACC -> AAGTGTACCG
GAAGTTCAAA -> AAGTTCAAAT
GAATAACGGA -> AATAACGGAG
GAATATATTA -> AATATATTAC
GAATATTCCA -> AATATTCCAG
GAATGCGCGA -> AATGCGCGAC
GAATGCGGCG -> AATGCGGCGC
GAATGTCTCA -> AATGTCTCAG
GAATTAGATC -> AATTAGATCT
GAATTAGTCT -> AATTAGTCTA
GACAAAAAGA -> ACAAAAAGAA
GACACGTAAC -> ACACGTAACA
GACAGATACT -> ACAGATACTC
GACAGATTAC -> ACAGATTACC
GACAGCACAA -> ACAGCACAAC
GACATCACGC -> ACATCACGCA
GACCAATCGG -> ACCAATCGGC
GACCACAAGT -> ACCACAAGTC
GACCAGAGGC -> ACCAGAGGCC
GACCAGTTCT -> ACCAGTTCTG
GACCATCCAT -> ACCATCCAT

GACCCCAATC -> ACCCCAATCC
GACCCGCAAA -> ACCCGCAAAT
GACCGCCAAG -> ACCGCCAAGC
GACCGGTGGA -> ACCGGTGGAG
GACCTTTAAC -> ACCTTTAACT
GACGAACCCC -> ACGAACCCCT
GACGACCGCC -> ACGACCGCCA
GACGACTTTA -> ACGACTTTAC
GACGATATAA -> ACGATATAAA
GACGCCTCAA -> ACGCCTCAAC
GACGTGTGTT -> ACGTGTGTTA
GACTACGGCC -> ACTACGGCCG
GACTAGGAGG -> ACTAGGAGGT
GACTCCCGAC -> ACTCCCGACT
GACTGAGAGG -> ACTGAGAGGG
GACTGGACTA -> ACTGGACTAC
GACTGTAAGC -> ACTGTAAGCT
GACTGTAGGA -> ACTGTAGGAG
GACTTACAGG -> ACTTACAGGG
GACTTTACAA -> ACTTTACAAT
GACTTTACAT -> ACTTTACATT
GAGAATGCGG -> AGAATGCGGC
GAGAGGGTCC -> AGAGGGTCCC
GAGAGGTAAT -> AGAGGTAATC
GAGATAAACC -> AGATAAACCG
GAGATACGCT -> AGATACGCTG
GAGATGGGAA -> AGATGGGAAT
GAGATGGGAT -> AGATGGGATC
GAGCGAATTA -> AGCGAATTAG
GAGCGCGCGC -> AGCGCGCGCT
GAGCTGTATT -> AGCTGTATTG
GAGCTTTTCA -> AGCTTTTCAA
GAGGACTGTA -> AGGACTGTAG
GAGGAGATAA -> AGGAGATAAA
GAGGCAACCC -> AGGCAACCCC
GAGGCCAGTG -> AGGCCAGTGA
GAGGCGAGTA -> AGGCGAGTAG
GAGGGGGGTT -> AGGGGGGTTT
GAGGGTCCCT -> AGGGTCCCTA
GAGGGTCGCG -> AGGGTCGCGA
GAGGGTGTTT -> AGGGTGTTTA
GAGGTAATCA -> AGGTAATCAG
GAGGTAGTTG -> AGGTAGTTGT
GAGTAAATTA -> AGTAAATTAG
GAGTACCGCG -> AGTACCGCGT
GAGTAGCTCT -> AGTAGCTCTG
GAGTATTATA -> AGTATTATAA
GAGTCGCCCG -> AGTCGCCCGG
GAGTCGCGGA -> AGTCGCGGAA
GAGTGCGTTG -> AGTGCGTTGT
GAGTGTACTT -> AGTGTACTTA
GAGTGTCCAT -> AGTGTCCATA
GAGTTGCTCG -> AGTTGCTCGT
GAGTTTAAAT -> AGTTTAAATT
GATAAACCGG -> ATAAACCGGT
GATAACGCAT -> ATAACGCATA
GATAACGCTT -> ATAACGCTTT
GATAAGATTT -> ATAAGATTTG
GATAAGTATG -> ATAAGTATGT
GATAATACTC -> ATAATACTCC
GATACCACGA -> ATACCACGAA
GATACGCTGT -> ATACGCTGTA
GATACTCAAC -> ATACTCAACA
GATACTCCGG -> ATACTCCGGC
GATAGTCCCA -> ATAGTCCCAT
GATATAAAGT -> ATATAAAGTA
GATATCGCCC -> ATATCGCCCG
GATATGAATT -> ATATGAATTA
GATCAAAGTA -> ATCAAAGTAC
GATCAACAAG -> ATCAACAAGC
GATCATAGGA -> ATCATAGGAG
GATCCGACGA -> ATCCGACGAC
GATCGCGTTG -> ATCGCGTTGA
GATCTAGTGT -> ATCTAGTGTT
GATCTCGGGT -> ATCTCGGGTT
GATCTGTGAA -> ATCTGTGAAG
GATGAGATGG -> ATGAGATGGG,ATGAGATGGG
GATGCGTTCG -> ATGCGTTCGT
GATGGGAATG -> ATGGGAATGT
GATGGGATCA -> ATGGGATCAT
GATGGGCTGT -> ATGGGCTGTG
GATTAATGGT -> ATTAATGGTC
GATTACCCTT -> ATTACCCTTT
GATTTGCTAT -> ATTTGCTATT
GCAAAAGTAC -> CAAAAGTACC
GCAAAATGGG -> CAAAATGGGT
GCAAATCCCT -> CAAATCCCTG
GCAACCCCAA -> CAACCCCAAT
GCAAGGGACA -> CAAGGGACAT
GCAATGGAAC -> CAATGGAACA
GCACAACATG -> CACAACATGC
GCACCACTCT -> CACCACTCTA
GCACTTCACA -> CACTTCACAT
GCAGACAGAT -> CAGACAGATT
GCAGATCGCG -> CAGATCGCGT
GCAGCCCACA -> CAGCCCACAA
GCAGCGAGAT -> CAGCGAGATA
GCAGCGAGTA -> CAGCGAGTAC
GCAGCGCGCA -> CAGCGCGCAA
GCAGCTGCAT -> CAGCTGCATG
GCAGCTTATA -> CAGCTTATAA
GCAGGACGAA -> CAGGACGAAC
GCATAATTAC -> CATAATTACC
GCATACATTC -> CATACATTCT
GCATCCTTGG -> CATCCTTGGA
GCATCGCAGC -> CATCGCAGCC
GCATCTCCCC -> CATCTCCCCG
GCATGAGTTG -> CATGAGTTGC
GCATGATGAG -> CATGATGAGA
GCATTTCGAA -> CATTTCGAAA
GCCAAGCCTC -> CCAAGCCTCG
GCCAATAACC -> CCAATAACCG
GCCAGTCATT -> CCAGTCATTG
GCCAGTGAAC -> CCAGTGAACG
GCCATTGGGC -> CCATTGGGCC
GCCCACAAGC -> CCCACAAGCG
GCCCAGTTCC -> CCCAGTTCCT
GCCCCCGGCT -> CCCCCGGCTG
GCCCCGGCAT -> CCCCGGCATT
GCCCGAATAT -> CCCGAATATT
GCCCGGATAA -> CCCGGATAAG
GCCGATAACG -> CCGATAACGC
GCCGCGATGG -> CCGCGATGGG
GCCGCGCGGT -> CCGCGCGGTT
GCCGGAGCGC -> CCGGAGCGCG
GCCGTCCATT -> CCGTCCATTA
GCCTACTGTC -> CCTACTGTCA
GCCTCAACCC -> CCTCAACCCA
GCCTCGGTGC -> CCTCGGTGCG
GCCTCGTAGA -> CCTCGTAGAC
GCCTCTGGTA -> CCTCTGGTAT
GCCTGGGTTC -> CCTGGGTTCA
GCGAACAATT -> CGAACAATTA
GCGAAGCCTA -> CGAAGCCTAC
GCGAAGTCCT -> CGAAGTCCTC
GCGAATAACG -> CGAATAACGG
GCGAATTAGT -> CGAATTAGTC
GCGACGATAT -> CGACGATATA
GCGACGCCTC -> CGACGCCTCA
GCGAGATACG -> CGAGATACGC
GCGAGGCAAC -> CGAGGCAACC
GCGAGTACCG -> CGAGTACCGC
GCGAGTAGCT -> CGAGTAGCTC
GCGAGTGTCC -> CGAGTGTCCA
GCGATGGGCT -> CGATGGGCTG
GCGCAAGGGA -> CGCAAGGGAC
GCGCCGCGCG -> CGCCGCGCGG
GCGCCTGGGT -> CGCCTGGGTT
GCGCGACGAT -> CGCGACGATA
GCGCGAGTGT -> CGCGAGTGTC
GCGCGCAAGG -> CGCGCAAGGG
GCGCGCCTGG -> CGCGCCTGGG
GCGCGCGCTT -> CGCGCGCTTT
GCGCGCTTTG -> CGCGCTTTGC
GCGCGGTTTG -> CGCGGTTTGT
GCGCTAGTGA -> CGCTAGTGAC
GCGCTGCTTT -> CGCTGCTTTC
GCGCTTTGCA -> CGCTTTGCAG
GCGGAAGTTC -> CGGAAGTTCA
GCGGCCAGTC -> CGGCCAGTCA
GCGGCGCTAG -> CGGCGCTAGT
GCGGGCAGCT -> CGGGCAGCTG
GCGGTCCAGC -> CGGTCCAGCG
GCGGTTTGTT -> CGGTTTGTTT
GCGTCTACAA -> CGTCTACAAG
GCGTCTGAGT -> CGTCTGAGTG
GCGTTACCAG -> CGTTACCAGA
GCGTTACTAG -> CGTTACTAGC
GCGTTATTCC -> CGTTATTCCG
GCGTTCGTCC -> CGTTCGTCCC
GCGTTGATCC -> CGTTGATCCG
GCGTTGTGCG -> CGTTGTGCGG
GCGTTTTAGT -> CGTTTTAGTC
GCTAGTGACC -> CTAGTGACCG
GCTATTAGAA -> CTATTAGAAC
GCTCGTATTC -> CTCGTATTCC
GCTCTGGACC -> CTCTGGACCT
GCTGACTCCC -> CTGACTCCCG
GCTGAGTAAA -> CTGAGTAAAT
GCTGAGTATT -> CTGAGTATTA
GCTGATCAAA -> CTGATCAAAG
GCTGCATACA -> CTGCATACAT
GCTGCATGAG -> CTGCATGAGT
GCTGCTTTCG -> CTGCTTTCGT
GCTGTACTCT -> CTGTACTCTA
GCTGTATTGA -> CTGTATTGAC
GCTGTGCAGG -> CTGTGCAGGA
GCTTAGAAAT -> CTTAGAAATA
GCTTAGTCAA -> CTTAGTCAAT
GCTTAGTCCA -> CTTAGTCCAA
GCTTATAACT -> CTTATAACTA
GCTTATAGCA -> CTTATAGCAT
GCTTTATTGC -> CTTTATTGCG
GCTTTCGTCT -> CTTTCGTCTA
GCTTTGCAGC -> CTTTGCAGCG
GCTTTTCAAA -> CTTTTCAAAT
GCTTTTGATA -> CTTTTGATAC
GGAACACGGG -> GAACACGGGT
GGAACGGACG -> GAACGGACGT
GGAAGCACTT -> GAAGCACTTC
GGAAGTTCAA -> GAAGTTCAAA
GGAATATATT -> GAATATATTA
GGAATGTCTC -> GAATGTCTCA
GGACATCACG -> GACATCACGC
GGACCAATCG -> GACCAATCGG
GGACCTTTAA -> GACCTTTAAC
GGACGAACCC -> GACGAACCCC
GGACGTGTGT -> GACGTGTGTT
GGACTACGGC -> GACTACGGCC
GGACTGTAAG -> GACTGTAAGC
GGACTGTAGG -> GACTGTAGGA
GGAGATAAAC -> GAGATAAACC
GGAGCGAATT -> GAGCGAATTA
GGAGCGCGCG -> GAGCGCGCGC
GGAGGACTGT -> GAGGACTGTA
GGAGGGGGGT -> GAGGGGGGTT
GGAGGGTCGC -> GAGGGTCGCG
GGAGGGTGTT -> GAGGGTGTTT
GGAGGTAGTT -> GAGGTAGTTG
GGAGTGCGTT -> GAGTGCGTTG
GGATAAGTAT -> GATAAGTATG
GGATAATACT -> GATAATACTC
GGATAGTCCC -> GATAGTCCCA
GGATCATAGG -> GATCATAGGA
GGATGAGATG -> GATGAGATGG
GGATTAATGG -> GATTAATGGT
GGCAAAAGTA -> GCAAAAGTAC
GGCAACCCCA -> GCAACCCCAA
GGCAGCTGCA -> GCAGCTGCAT
GGCATTTCGA -> GCATTTCGAA
GGCCAGTCAT -> GCCAGTCATT
GGCCAGTGAA -> GCCAGTGAAC
GGCCATTGGG -> GCCATTGGGC
GGCCCCGGCA -> GCCCCGGCAT
GGCCGATAAC -> GCCGATAACG
GGCCGCGATG -> GCCGCGATGG
GGCCGTCCAT -> GCCGTCCATT
GGCCTCGTAG -> GCCTCGTAGA
GGCGAGTAGC -> GCGAGTAGCT
GGCGCTAGTG -> GCGCTAGTGA
GGCGTCTACA -> GCGTCTACAA
GGCGTCTGAG -> GCGTCTGAGT
GGCTGAGTAT -> GCTGAGTATT
GGCTGTGCAG -> GCTGTGCAGG
GGGAACGGAC -> GGAACGGACG
GGGAATGTCT -> GGAATGTCTC
GGGACATCAC -> GGACATCACG
GGGATAGTCC -> GGATAGTCCC
GGGATCATAG -> GGATCATAGG
GGGCAGCTGC -> GGCAGCTGCA
GGGCCCCGGC -> GGCCCCGGCA
GGGCCTCGTA -> GGCCTCGTAG
GGGCTGTGCA -> GGCTGTGCAG
GGGGATAGTC -> GGGATAGTCC
GGGGGGTTTG -> GGGGGTTTGG
GGGGGTTTGG -> GGGGTTTGGA
GGGGTCTACG -> GGGTCTACGT
GGGGTTTGGA -> GGGTTTGGAG
GGGTATAATC -> GGTATAATCC
GGGTCCCTAC -> GGTCCCTACC
GGGTCGCGAG -> GGTCGCGAGG
GGGTCTACGT -> GGTCTACGTA
GGGTCTCTAT -> GGTCTCTATC
GGGTGTTTAA -> GGTGTTTAAT
GGGTTATCGT -> GGTTATCGTG
GGGTTCAATT -> GGTTCAATTC
GGGTTCCCTA -> GGTTCCCTAC
GGGTTTGGAG -> GGTTTGGAGG
GGTAATCAGC -> GTAATCAGCT
GGTACGACCA -> GTACGACCAG
GGTACTTGGA -> GTACTTGGAC
GGTAGTTGTA -> GTAGTTGTAG
GGTATAATCC -> GTATAATCCA
GGTATAATTC -> GTATAATTCG
GGTATACCCC -> GTATACCCCT
GGTATTCAGA -> GTATTCAGAT
GGTCCAGCGC -> GTCCAGCGCG
GGTCCCTACC -> GTCCCTACCC
GGTCCCTGAG -> GTCCCTGAGT
GGTCCGACAA -> GTCCGACAAA
GGTCGAGTCG -> GTCGAGTCGC
GGTCGCGAGG -> GTCGCGAGGC
GGTCTACGTA -> GTCTACGTAA
GGTCTCACTC -> GTCTCACTCG
GGTCTCTATC -> GTCTCTATCC
GGTGAGGCGA -> GTGAGGCGAG
GGTGCGTTAT -> GTGCGTTATT
GGTGGAGCGA -> GTGGAGCGAA
GGTGGGGATA -> GTGGGGATAG
GGTGTCATTA -> GTGTCATTAG
GGTGTTTAAT -> GTGTTTAATC
GGTTATCGTG -> GTTATCGTGT
GGTTCAATTC -> GTTCAATTCA
GGTTCCCTAC -> GTTCCCTACA
GGTTTGGAGG -> GTTTGGAGGA
GGTTTGTTTA -> GTTTGTTTAC
GTAAACCGGT -> TAAACCGGTG
GTAAATTAGA -> TAAATTAGAC
GTAACAGTTC -> TAACAGTTCC
GTAAGATGCG -> TAAGATGCGT
GTAAGCTTAG -> TAAGCTTAGA
GTAAGGATTA -> TAAGGATTAA
GTAAGGGGTC -> TAAGGGGTCT
GTAATCAGCT -> TAATCAGCTT
GTACCCAGTG -> TACCCAGTGC
GTACCCTACG -> TACCCTACGC
GTACCGACCA -> TACCGACCAT
GTACCGCGTT -> TACCGCGTTT
GTACCTCGCG -> TACCTCGCGA
GTACGAAGTG -> TACGAAGTGT
GTACGACACG -> TACGACACGT
GTACGACCAG -> TACGACCAGA
GTACTCTAAT -> TACTCTAATC,TACTCTAATA
GTACTTAGGA -> TACTTAGGAG
GTACTTGGAC -> TACTTGGACC
GTAGACTTTA -> TAGACTTTAC
GTAGCAAAAT -> TAGCAAAATG
GTAGCTCTGG -> TAGCTCTGGA
GTAGGAGTGC -> TAGGAGTGCG
GTAGTTGTAG -> TAGTTGTAGC
GTATAATCCA -> TATAATCCAC
GTATAATTCG -> TATAATTCGG
GTATACCCCT -> TATACCCCTG
GTATAGTTTC -> TATAGTTTCT
GTATGTCGCC -> TATGTCGCCG
GTATTATAAT -> TATTATAATC
GTATTCAGAT -> TATTCAGATA
GTATTCCACC -> TATTCCACCA
GTATTGACCA -> TATTGACCAG
GTCAAGTGAC -> TCAAGTGACT
GTCAATCTCT -> TCAATCTCTC
GTCACTACAG -> TCACTACAGT
GTCATTAGGT -> TCATTAGGTA
GTCATTGTGG -> TCATTGTGGC
GTCCAAGAAG -> TCCAAGAAGA
GTCCAGCGCG -> TCCAGCGCGA
GTCCATATGT -> TCCATATGTA
GTCCATTAAT -> TCCATTAATC
GTCCCATGCA -> TCCCATGCAG
GTCCCTACCC -> TCCCTACCCT
GTCCCTGAGT -> TCCCTGAGTT
GTCCCTTAAG -> TCCCTTAAGT
GTCCGACAAA -> TCCGACAAAA
GTCCTCCGTA -> TCCTCCGTAT
GTCCTCTTGT -> TCCTCTTGTT
GTCGAGTCGC -> TCGAGTCGCC
GTCGCATGAT -> TCGCATGATG
GTCGCCCGGA -> TCGCCCGGAT
GTCGCCGGAG -> TCGCCGGAGC
GTCGCGAGGC -> TCGCGAGGCA
GTCGCGGAAG -> TCGCGGAAGT
GTCGCTTAGT -> TCGCTTAGTC
GTCGCTTATA -> TCGCTTATAG
GTCTAAACAG -> TCTAAACAGG
GTCTACAAGA -> TCTACAAGAC
GTCTACGTAA -> TCTACGTAAG
GTCTACTCGA -> TCTACTCGAG
GTCTATTAGT -> TCTATTAGTG
GTCTCACTCG -> TCTCACTCGC
GTCTCAGTAA -> TCTCAGTAAG
GTCTCTATCC -> TCTCTATCCA
GTCTGAGTGT -> TCTGAGTGTA
GTGAAAGGCA -> TGAAAGGCAA
GTGAACGATA -> TGAACGATAC
GTGAAGCGAA -> TGAAGCGAAG
GTGACCGGTG -> TGACCGGTGG
GTGACTGAGA -> TGACTGAGAG
GTGAGGCGAG -> TGAGGCGAGT
GTGCAATGGA -> TGCAATGGAA
GTGCAGGACG -> TGCAGGACGA
GTGCATCTCC -> TGCATCTCCC
GTGCCAATAA -> TGCCAATAAC
GTGCGGTCCA -> TGCGGTCCAG
GTGCGTTATT -> TGCGTTATTC
GTGCGTTGTG -> TGCGTTGTGC
GTGCTTTATT -> TGCTTTATTG
GTGGAGCGAA -> TGGAGCGAAT
GTGGCCATTG -> TGGCCATTGG
GTGGGGATAG -> TGGGGATAGT
GTGGTACGAC -> TGGTACGACC
GTGTACCGAC -> TGTACCGACC
GTGTACTCTA -> TGTACTCTAA
GTGTACTTAG -> TGTACTTAGG
GTGTCATTAG -> TGTCATTAGG
GTGTCCATAT -> TGTCCATATG
GTGTGTTAAT -> TGTGTTAATT
GTGTGTTATT -> TGTGTTATTG
GTGTTAATTC -> TGTTAATTCA
GTGTTATTGC -> TGTTATTGCC
GTGTTCGTAC -> TGTTCGTACG
GTGTTTAATC -> TGTTTAATCA
GTTAATTCAA -> TTAATTCAAG
GTTACCAGAT -> TTACCAGATA
GTTACTAGCT -> TTACTAGCTG
GTTATCGTGT -> TTATCGTGTG
GTTATGCAGC -> TTATGCAGCT
GTTATTCCGA -> TTATTCCGAG
GTTATTGCCT -> TTATTGCCTC
GTTCAAATAC -> TTCAAATACA
GTTCAACAAA -> TTCAACAAAC
GTTCAATTCA -> TTCAATTCAT
GTTCAGGTCC -> TTCAGGTCCG
GTTCCATATG -> TTCCATATGC
GTTCCCTACA -> TTCCCTACAT
GTTCCTTACC -> TTCCTTACCT
GTTCGTACGA -> TTCGTACGAA
GTTCGTCCCT -> TTCGTCCCTT
GTTCTGTTGA -> TTCTGTTGAG
GTTGACCCCA -> TTGACCCCAA
GTTGACGACT -> TTGACGACTT
GTTGAGCTTT -> TTGAGCTTTT
GTTGATCCGA -> TTGATCCGAC
GTTGCTCGTA -> TTGCTCGTAT
GTTGGCCGCG -> TTGGCCGCGA
GTTGTAGCAA -> TTGTAGCAAA
GTTGTGCGGT -> TTGTGCGGTC
GTTTAAATTC -> TTTAAATTCT
GTTTAATCAA -> TTTAATCAAA
GTTTACCGAT -> TTTACCGATA
GTTTCTGAAC -> TTTCTGAACA
GTTTGGAGGA -> TTTGGAGGAC
GTTTGTTTAC -> TTTGTTTACC
GTTTTAGTCA -> TTTTAGTCAA
GTTTTTCAAG -> TTTTTCAAGC
TAAACAGGAA -> AAACAGGAAT
TAAACCGGTA -> AAACCGGTAT
TAAACCGGTG -> AAACCGGTGG
TAAACTAACA -> AAACTAACAC
TAAAGCTGAG -> AAAGCTGAGT
TAAAGTAAAC -> AAAGTAAACC
TAAATTAGAC -> AAATTAGACT
TAAATTCTAA -> AAATTCTAAC
TAAATTCTGG -> AAATTCTGGC
TAACACATGC -> AACACATGCA
TAACAGTTCC -> AACAGTTCCA
TAACCGCCCA -> AACCGCCCAG
TAACGCATAA -> AACGCATAAT
TAACGCGCCG -> AACGCGCCGC
TAACGCTTTT -> AACGCTTTTG
TAACGGAGGG -> AACGGAGGGT
TAACTATTGG -> AACTATTGGA
TAACTTTAGA -> AACTTTAGAG
TAAGATGCGT -> AAGATGCGTT
TAAGATTTGC -> AAGATTTGCT
TAAGCTGACT -> AAGCTGACTC
TAAGCTTAGA -> AAGCTTAGAA
TAAGGATTAA -> AAGGATTAAT
TAAGGGGTCT -> AAGGGGTCTA
TAAGTATGTC -> AAGTATGTCG
TAAGTGGTAC -> AAGTGGTACG
TAAGTGTACT -> AAGTGTACTC
TAAGTTGACG -> AAGTTGACGA
TAATACTCCG -> AATACTCCGA
TAATATGTCG -> AATATGTCGC
TAATCAAATT -> AATCAAATTG
TAATCAGCTT -> AATCAGCTTA
TAATCCACGT -> AATCCACGTT
TAATCCCAAT -> AATCCCAATC
TAATCTTGTT -> AATCTTGTTT
TAATCTTTGA -> AATCTTTGAG
TAATGGTCCC -> AATGGTCCCT
TAATTACCTC -> AATTACCTCT
TAATTCAAGC -> AATTCAAGCA
TAATTCGGTA -> AATTCGGTAC
TACAAATCCC -> ACAAATCCCT
TACAAGACCC -> ACAAGACCCG
TACAATCAGA -> ACAATCAGAT
TACAGACCAC -> ACAGACCACA
TACAGGGCCT -> ACAGGGCCTC
TACAGTTCAG -> ACAGTTCAGG
TACATCCACC -> ACATCCACCT
TACATTCGCG -> ACATTCGCGT
TACATTCTAA -> ACATTCTAAG
TACCACGAAC -> ACCACGAACA
TACCAGATAA -> ACCAGATAAG
TACCCAGTGC -> ACCCAGTGCC
TACCCCTGCA -> ACCCCTGCAG
TACCCTACGC -> ACCCTACGCC
TACCCTGGTG -> ACCCTGGTGT
TACCCTTTGC -> ACCCTTTGCT
TACCGACCAT -> ACCGACCATC
TACCGATATG -> ACCGATATGA
TACCGCGTTT -> ACCGCGTTTT
TACCGGTCTC -> ACCGGTCTCA
TACCTCAACG -> ACCTCAACGT
TACCTCGCGA -> ACCTCGCGAC
TACCTCTGAT -> ACCTCTGATC
TACCTTAAGT -> ACCTTAAGTT
TACGAAGTGT -> ACGAAGTGTA
TACGACACGT -> ACGACACGTA
TACGACCAGA -> ACGACCAGAG
TACGACTAGG -> ACGACTAGGA
TACGCCCCCG -> ACGCCCCCGG
TACGCTGTAC -> ACGCTGTACT
TACGGCCGTC -> ACGGCCGTCC
TACGTAAGGA -> ACGTAAGGAT
TACTAGCTGC -> ACTAGCTGCA
TACTCAACAG -> ACTCAACAGG
TACTCCGAGG -> ACTCCGAGGA
TACTCCGGCG -> ACTCCGGCGT
TACTCGAGAA -> ACTCGAGAAT
TACTCTAATA -> ACTCTAATAT
TACTCTAATC -> ACTCTAATCT
TACTGTCACT -> ACTGTCACTA
TACTGTCCTC -> ACTGTCCTCC
TACTTAGGAG -> ACTTAGGAGG
TACTTCTAGC -> ACTTCTAGCG
TACTTGGACC -> ACTTGGACCA
TAGAAATATT -> AGAAATATTA
TAGAACGTGC -> AGAACGTGCA
TAGACTTACA -> AGACTTACAG
TAGACTTTAC -> AGACTTTACA
TAGAGTCGCG -> AGAGTCGCGG
TAGATCTCGG -> AGATCTCGGG
TAGCAAAATG -> AGCAAAATGG
TAGCATCCTT -> AGCATCCTTG
TAGCGAAGTC -> AGCGAAGTCC
TAGCTCTGGA -> AGCTCTGGAC
TAGCTGCATA -> AGCTGCATAC
TAGGAGGGGG -> AGGAGGGGGG
TAGGAGGGTC -> AGGAGGGTCG
TAGGAGGTAG -> AGGAGGTAGT
TAGGAGTGCG -> AGGAGTGCGT
TAGGTATACC -> AGGTATACCC
TAGTCAAGTG -> AGTCAAGTGA
TAGTCAATCT -> AGTCAATCTC
TAGTCCAAGA -> AGTCCAAGAA
TAGTCCCATG -> AGTCCCATGC
TAGTCTAAAC -> AGTCTAAACA
TAGTGACCGG -> AGTGACCGGT
TAGTGCATCT -> AGTGCATCTC
TAGTGCTTTA -> AGTGCTTTAT
TAGTGTTCGT -> AGTGTTCGTA
TAGTTGTAGC -> AGTTGTAGCA
TAGTTTCTGA -> AGTTTCTGAA
TATAAAGTAA -> ATAAAGTAAA
TATAACTATT -> ATAACTATTG
TATAAGCTGA -> ATAAGCTGAC
TATAATCCAC -> ATAATCCACG
TATAATCTTG -> ATAATCTTGT
TATAATTCGG -> ATAATTCGGT
TATACCCCTG -> ATACCCCTGC
TATACGACTA -> ATACGACTAG
TATAGCATCC -> ATAGCATCCT
TATAGTTTCT -> ATAGTTTCTG
TATATACGAC -> ATATACGACT
TATATTACCT -> ATATTACCTT
TATCCACTTG -> ATCCACTTGG
TATCGCCCGA -> ATCGCCCGAA
TATCGTGTGT -> ATCGTGTGTT
TATGAATTAG -> ATGAATTAGA
TATGCAGCTT -> ATGCAGCTTA
TATGCGCTGC -> ATGCGCTGCT
TATGTACCCT -> ATGTACCCTA
TATGTCGCAT -> ATGTCGCATG
TATGTCGCCG -> ATGTCGCCGG
TATGTCGCTT -> ATGTCGCTTA
TATTACCTTA -> ATTACCTTAA
TATTAGAACG -> ATTAGAACGT
TATTAGTGCA -> ATTAGTGCAT
TATTATAATC -> ATTATAATCT
TATTATGTCG -> ATTATGTCGC
TATTCAGATA -> ATTCAGATAA
TATTCCACCA -> ATTCCACCAA
TATTCCAGGA -> ATTCCAGGAT
TATTCCGAGA -> ATTCCGAGAG
TATTGACCAG -> ATTGACCAGT
TATTGCCTCT -> ATTGCCTCTG
TATTGCGGCC -> ATTGCGGCCA
TATTGGACTG -> ATTGGACTGT
TCAAAGTACC -> CAAAGTACCC
TCAAATACAG -> CAAATACAGA
TCAAATACTG -> CAAATACTGT
TCAAATTGGT -> CAAATTGGTG
TCAACAAACT -> CAACAAACTC
TCAACAAGCG -> CAACAAGCGG
TCAACAGGTC -> CAACAGGTCG
TCAACCCACG -> CAACCCACGT
TCAACGTCGC -> CAACGTCGCT
TCAAGCAGAT -> CAAGCAGATC
TCAAGCAGCG -> CAAGCAGCGA
TCAAGTGACT -> CAAGTGACTG
TCAATCTCTC -> CAATCTCTCC
TCAATTCATA -> CAATTCATAA
TCACATAAAC -> CACATAAACT
TCACCAAGAA -> CACCAAGAAA
TCACGCATCG -> CACGCATCGC
TCACTACAGT -> CACTACAGTT
TCACTCGCGA -> CACTCGCGAA
TCAGATAACG -> CAGATAACGC
TCAGATCTAG -> CAGATCTAGT
TCAGCTTAGT -> CAGCTTAGTC
TCAGGTCCGA -> CAGGTCCGAC
TCAGTAAGGG -> CAGTAAGGGG
TCATAAATTC -> CATAAATTCT
TCATAGGAGG -> CATAGGAGGG
TCATTAGGTA -> CATTAGGTAT
TCATTGTGGC -> CATTGTGGCC
TCCAAGAAGA -> CCAAGAAGAT
TCCACCAAAG -> CCACCAAAGA
TCCACCTTGA -> CCACCTTGAA
TCCACGTTAT -> CCACGTTATG
TCCACGTTGA -> CCACGTTGAC
TCCACTTGGG -> CCACTTGGGA
TCCAGCGCGA -> CCAGCGCGAG
TCCAGGATAA -> CCAGGATAAT
TCCATATGCG -> CCATATGCGC
TCCATATGTA -> CCATATGTAC
TCCATTAATC -> CCATTAATCC
TCCCAATCTC -> CCCAATCTCT
TCCCATGCAG -> CCCATGCAGC
TCCCCGCGCG -> CCCCGCGCGC
TCCCGACTGG -> CCCGACTGGA
TCCCTACATC -> CCCTACATCC
TCCCTACCCT -> CCCTACCCTG
TCCCTGAGTT -> CCCTGAGTTT
TCCCTGTGAA -> CCCTGTGAAA
TCCCTTAAGT -> CCCTTAAGTG
TCCCTTTATA -> CCCTTTATAA
TCCGACAAAA -> CCGACAAAAA
TCCGACGACC -> CCGACGACCG
TCCGAGAGGT -> CCGAGAGGTA
TCCGAGGAGA -> CCGAGGAGAT
TCCGGAAGCA -> CCGGAAGCAC
TCCGGCGTCT -> CCGGCGTCTA
TCCGTATAGT -> CCGTATAGTT
TCCTCCGTAT -> CCTCCGTATA
TCCTCTTGTT -> CCTCTTGTTG
TCCTTACCTC -> CCTTACCTCA
TCCTTGGATG -> CCTTGGATGA
TCGAAATACC -> CGAAATACCG
TCGAGAATGC -> CGAGAATGCG
TCGAGTCGCC -> CGAGTCGCCC
TCGCAGCCCA -> CGCAGCCCAC
TCGCATGATG -> CGCATGATGA
TCGCCCGAAT -> CGCCCGAATA
TCGCCCGGAT -> CGCCCGGATA
TCGCCGGAGC -> CGCCGGAGCG
TCGCGAACAA -> CGCGAACAAT
TCGCGACGCC -> CGCGACGCCT
TCGCGAGGCA -> CGCGAGGCAA
TCGCGGAAGT -> CGCGGAAGTT
TCGCGTTACC -> CGCGTTACCA
TCGCGTTGAT -> CGCGTTGATC
TCGCTTAGTC -> CGCTTAGTCA
TCGCTTATAG -> CGCTTATAGC
TCGGCGTCTG -> CGGCGTCTGA
TCGGGTTATC -> CGGGTTATCG
TCGGTACTTG -> CGGTACTTGG
TCGGTGCGTT -> CGGTGCGTTA
TCGTACGAAG -> CGTACGAAGT
TCGTAGACTT -> CGTAGACTTT
TCGTATTCCA -> CGTATTCCAC
TCGTCCCTTA -> CGTCCCTTAA
TCGTCTATTA -> CGTCTATTAG
TCGTGTGTTA -> CGTGTGTTAA
TCTAAACAGG -> CTAAACAGGA
TCTAACGCGC -> CTAACGCGCC
TCTAAGTGTA -> CTAAGTGTAC
TCTAATATGT -> CTAATATGTC
TCTAATCTTT -> CTAATCTTTG
TCTACAAGAC -> CTACAAGACC
TCTACGTAAG -> CTACGTAAGG
TCTACTCGAG -> CTACTCGAGA
TCTAGCGAAG -> CTAGCGAAGT
TCTAGTGCTT -> CTAGTGCTTT
TCTAGTGTTC -> CTAGTGTTCG
TCTATCCACT -> CTATCCACTT
TCTATTAGTG -> CTATTAGTGC
TCTCACTCGC -> CTCACTCGCG
TCTCAGTAAG -> CTCAGTAAGG
TCTCCACGTT -> CTCCACGTTG
TCTCCCCGCG -> CTCCCCGCGC
TCTCGGGTTA -> CTCGGGTTAT
TCTCTATCCA -> CTCTATCCAC
TCTCTCCACG -> CTCTCCACGT
TCTCTTTACT -> CTCTTTACTT
TCTCTTTATA -> CTCTTTATAT
TCTGAACAGA -> CTGAACAGAT
TCTGACAGAT -> CTGACAGATA
TCTGAGTGTA -> CTGAGTGTAC
TCTGATCTGT -> CTGATCTGTG
TCTGGACCTT -> CTGGACCTTT
TCTGGCCGAT -> CTGGCCGATA
TCTGGTATTC -> CTGGTATTCA
TCTGTGAAGC -> CTGTGAAGCG
TCTGTTGAGC -> CTGTTGAGCT
TCTTGTTGGC -> CTTGTTGGCC
TCTTGTTTTT -> CTTGTTTTTC
TCTTTACTTC -> CTTTACTTCT
TCTTTATATA -> CTTTATATAC
TCTTTGAGCT -> CTTTGAGCTG
TGAAAGGCAA -> GAAAGGCAAA
TGAACAGATA -> GAACAGATAT
TGAACGATAC -> GAACGATACC
TGAAGCGAAG -> GAAGCGAAGC
TGAATGCGCG -> GAATGCGCGA
TGAATTAGAT -> GAATTAGATC
TGACAGATAC -> GACAGATACT
TGACCAGTTC -> GACCAGTTCT
TGACCCCAAT -> GACCCCAATC
TGACCGGTGG -> GACCGGTGGA
TGACGACTTT -> GACGACTTTA
TGACTCCCGA -> GACTCCCGAC
TGACTGAGAG -> GACTGAGAGG
TGAGAGGGTC -> GAGAGGGTCC
TGAGATGGGA -> GAGATGGGAT,GAGATGGGAA
TGAGCTGTAT -> GAGCTGTATT
TGAGCTTTTC -> GAGCTTTTCA
TGAGGCGAGT -> GAGGCGAGTA
TGAGTAAATT -> GAGTAAATTA
TGAGTATTAT -> GAGTATTATA
TGAGTGTACT -> GAGTGTACTT
TGAGTTGCTC -> GAGTTGCTCG
TGAGTTTAAA -> GAGTTTAAAT
TGATACTCAA -> GATACTCAAC
TGATCAAAGT -> GATCAAAGTA
TGATCCGACG -> GATCCGACGA
TGATCTGTGA -> GATCTGTGAA
TGATGAGATG -> GATGAGATGG
TGCAATGGAA -> GCAATGGAAC
TGCACCACTC -> GCACCACTCT
TGCAGACAGA -> GCAGACAGAT
TGCAGCGAGA -> GCAGCGAGAT
TGCAGCGCGC -> GCAGCGCGCA
TGCAGCTTAT -> GCAGCTTATA
TGCAGGACGA -> GCAGGACGAA
TGCATACATT -> GCATACATTC
TGCATCTCCC -> GCATCTCCCC
TGCATGAGTT -> GCATGAGTTG
TGCCAATAAC -> GCCAATAACC
TGCCTCTGGT -> GCCTCTGGTA
TGCGAATAAC -> GCGAATAACG
TGCGCGACGA -> GCGCGACGAT
TGCGCTGCTT -> GCGCTGCTTT
TGCGGCCAGT -> GCGGCCAGTC
TGCGGCGCTA -> GCGGCGCTAG
TGCGGTCCAG -> GCGGTCCAGC
TGCGTTATTC -> GCGTTATTCC
TGCGTTCGTC -> GCGTTCGTCC
TGCGTTGTGC -> GCGTTGTGCG
TGCTATTAGA -> GCTATTAGAA
TGCTCGTATT -> GCTCGTATTC
TGCTGATCAA -> GCTGATCAAA
TGCTTTATTG -> GCTTTATTGC
TGCTTTCGTC -> GCTTTCGTCT
TGGAACACGG -> GGAACACGGG
TGGACCAATC -> GGACCAATCG
TGGACCTTTA -> GGACCTTTAA
TGGACTACGG -> GGACTACGGC
TGGACTGTAA -> GGACTGTAAG
TGGAGCGAAT -> GGAGCGAATT
TGGAGGACTG -> GGAGGACTGT
TGGATGAGAT -> GGATGAGATG
TGGCCATTGG -> GGCCATTGGG
TGGCCGATAA -> GGCCGATAAC
TGGCCGCGAT -> GGCCGCGATG
TGGGAACGGA -> GGGAACGGAC
TGGGAATGTC -> GGGAATGTCT
TGGGATCATA -> GGGATCATAG
TGGGCCCCGG -> GGGCCCCGGC
TGGGCTGTGC -> GGGCTGTGCA
TGGGGATAGT -> GGGGATAGTC
TGGGTATAAT -> GGGTATAATC
TGGGTTCAAT -> GGGTTCAATT
TGGTACGACC -> GGTACGACCA
TGGTATTCAG -> GGTATTCAGA
TGGTCCCTGA -> GGTCCCTGAG
TGGTGAGGCG -> GGTGAGGCGA
TGGTGTCATT -> GGTGTCATTA
TGTAAGCTTA -> GTAAGCTTAG
TGTACCCTAC -> GTACCCTACG
TGTACCGACC -> GTACCGACCA
TGTACTCTAA -> GTACTCTAAT,GTACTCTAAT
TGTACTTAGG -> GTACTTAGGA
TGTAGCAAAA -> GTAGCAAAAT
TGTAGGAGTG -> GTAGGAGTGC
TGTATTGACC -> GTATTGACCA
TGTCACTACA -> GTCACTACAG
TGTCATTAGG -> GTCATTAGGT
TGTCCATATG -> GTCCATATGT
TGTCCTCCGT -> GTCCTCCGTA
TGTCGCATGA -> GTCGCATGAT
TGTCGCCGGA -> GTCGCCGGAG
TGTCGCTTAG -> GTCGCTTAGT
TGTCTCAGTA -> GTCTCAGTAA
TGTGAAAGGC -> GTGAAAGGCA
TGTGAAGCGA -> GTGAAGCGAA
TGTGCAGGAC -> GTGCAGGACG
TGTGCGGTCC -> GTGCGGTCCA
TGTGGCCATT -> GTGGCCATTG
TGTGTTAATT -> GTGTTAATTC
TGTGTTATTG -> GTGTTATTGC
TGTTAATTCA -> GTTAATTCAA
TGTTATTGCC -> GTTATTGCCT
TGTTCGTACG -> GTTCGTACGA
TGTTGAGCTT -> GTTGAGCTTT
TGTTGGCCGC -> GTTGGCCGCG
TGTTTAATCA -> GTTTAATCAA
TGTTTACCGA -> GTTTACCGAT
TGTTTTTCAA -> GTTTTTCAAG
TTAAAGCTGA -> TAAAGCTGAG
TTAAATTCTA -> TAAATTCTAA
TTAACTTTAG -> TAACTTTAGA
TTAAGTGGTA -> TAAGTGGTAC
TTAAGTTGAC -> TAAGTTGACG
TTAATCAAAT -> TAATCAAATT
TTAATCCCAA -> TAATCCCAAT
TTAATGGTCC -> TAATGGTCCC
TTAATTCAAG -> TAATTCAAGC
TTACAATCAG -> TACAATCAGA
TTACAGGGCC -> TACAGGGCCT
TTACATTCGC -> TACATTCGCG
TTACCAGATA -> TACCAGATAA
TTACCCTTTG -> TACCCTTTGC
TTACCGATAT -> TACCGATATG
TTACCTCAAC -> TACCTCAACG
TTACCTCTGA -> TACCTCTGAT
TTACCTTAAG -> TACCTTAAGT
TTACTAGCTG -> TACTAGCTGC
TTACTTCTAG -> TACTTCTAGC
TTAGAAATAT -> TAGAAATATT
TTAGAACGTG -> TAGAACGTGC
TTAGACTTAC -> TAGACTTACA
TTAGAGTCGC -> TAGAGTCGCG
TTAGATCTCG -> TAGATCTCGG
TTAGGAGGGT -> TAGGAGGGTC
TTAGGTATAC -> TAGGTATACC
TTAGTCAAGT -> TAGTCAAGTG
TTAGTCAATC -> TAGTCAATCT
TTAGTCCAAG -> TAGTCCAAGA
TTAGTCTAAA -> TAGTCTAAAC
TTAGTGCATC -> TAGTGCATCT
TTATAACTAT -> TATAACTATT
TTATAAGCTG -> TATAAGCTGA
TTATAATCTT -> TATAATCTTG
TTATAGCATC -> TATAGCATCC
TTATATACGA -> TATATACGAC
TTATCGTGTG -> TATCGTGTGT
TTATGCAGCT -> TATGCAGCTT
TTATGTCGCA -> TATGTCGCAT
TTATTCCGAG -> TATTCCGAGA
TTATTGCCTC -> TATTGCCTCT
TTATTGCGGC -> TATTGCGGCC
TTCAAATACA -> TCAAATACAG
TTCAAATACT -> TCAAATACTG
TTCAACAAAC -> TCAACAAACT
TTCAAGCAGA -> TCAAGCAGAT
TTCAAGCAGC -> TCAAGCAGCG
TTCAATTCAT -> TCAATTCATA
TTCACATAAA -> TCACATAAAC
TTCAGATAAC -> TCAGATAACG
TTCAGGTCCG -> TCAGGTCCGA
TTCATAAATT -> TCATAAATTC
TTCCACCAAA -> TCCACCAAAG
TTCCAGGATA -> TCCAGGATAA
TTCCATATGC -> TCCATATGCG
TTCCCTACAT -> TCCCTACATC
TTCCGAGAGG -> TCCGAGAGGT
TTCCTTACCT -> TCCTTACCTC
TTCGAAATAC -> TCGAAATACC
TTCGCGTTAC -> TCGCGTTACC
TTCGGTACTT -> TCGGTACTTG
TTCGTACGAA -> TCGTACGAAG
TTCGTCCCTT -> TCGTCCCTTA
TTCGTCTATT -> TCGTCTATTA
TTCTAACGCG -> TCTAACGCGC
TTCTAAGTGT -> TCTAAGTGTA
TTCTAGCGAA -> TCTAGCGAAG
TTCTGAACAG -> TCTGAACAGA
TTCTGGCCGA -> TCTGGCCGAT
TTCTGTTGAG -> TCTGTTGAGC
TTGAATGCGC -> TGAATGCGCG
TTGACCAGTT -> TGACCAGTTC
TTGACCCCAA -> TGACCCCAAT
TTGACGACTT -> TGACGACTTT
TTGAGCTGTA -> TGAGCTGTAT
TTGAGCTTTT -> TGAGCTTTTC
TTGATACTCA -> TGATACTCAA
TTGATCCGAC -> TGATCCGACG
TTGCAGCGAG -> TGCAGCGAGA
TTGCCTCTGG -> TGCCTCTGGT
TTGCGGCCAG -> TGCGGCCAGT
TTGCTATTAG -> TGCTATTAGA
TTGCTCGTAT -> TGCTCGTATT
TTGCTGATCA -> TGCTGATCAA
TTGGACCAAT -> TGGACCAATC
TTGGACTGTA -> TGGACTGTAA
TTGGAGGACT -> TGGAGGACTG
TTGGATGAGA -> TGGATGAGAT
TTGGCCGCGA -> TGGCCGCGAT
TTGGGAACGG -> TGGGAACGGA
TTGGGCCCCG -> TGGGCCCCGG
TTGGTGAGGC -> TGGTGAGGCG
TTGTAGCAAA -> TGTAGCAAAA
TTGTGCGGTC -> TGTGCGGTCC
TTGTGGCCAT -> TGTGGCCATT
TTGTTGGCCG -> TGTTGGCCGC
TTGTTTACCG -> TGTTTACCGA
TTGTTTTTCA -> TGTTTTTCAA
TTTAAATTCT -> TTAAATTCTA
TTTAACTTTA -> TTAACTTTAG
TTTAATCAAA -> TTAATCAAAT
TTTACAATCA -> TTACAATCAG
TTTACATTCG -> TTACATTCGC
TTTACCGATA -> TTACCGATAT
TTTACTTCTA -> TTACTTCTAG
TTTAGAGTCG -> TTAGAGTCGC
TTTAGTCAAG -> TTAGTCAAGT
TTTATAAGCT -> TTATAAGCTG
TTTATATACG -> TTATATACGA
TTTATTGCGG -> TTATTGCGGC
TTTCAAATAC -> TTCAAATACT
TTTCAAGCAG -> TTCAAGCAGC
TTTCGAAATA -> TTCGAAATAC
TTTCGTCTAT -> TTCGTCTATT
TTTCTGAACA -> TTCTGAACAG
TTTGAGCTGT -> TTGAGCTGTA
TTTGATACTC -> TTGATACTCA
TTTGCAGCGA -> TTGCAGCGAG
TTTGCTATTA -> TTGCTATTAG
TTTGCTGATC -> TTGCTGATCA
TTTGGAGGAC -> TTGGAGGACT
TTTGTTTACC -> TTGTTTACCG
TTTTAGTCAA -> TTTAGTCAAG
TTTTCAAATA -> TTTCAAATAC
TTTTCAAGCA -> TTTCAAGCAG
TTTTGATACT -> TTTGATACTC
TTTTTCAAGC -> TTTTCAAGCA
